,budget_rank,budget,domestic_gross,worldwide_gross,dom_profits,total_profits,budget_quart,profit_transform,dom_profit_transform,rating,critic_rating,aud_rating,release_date
Avatar,1,425000000,760507625,2783918982,335507625,2358918982,143.581085551,21.6272285801,20.1023443293,68,83,82,2009-12-18
Pirates of the Caribbean: At World's End,2,300000000,309420425,963420425,9420425,663420425,131.607401295,20.4669153207,19.1690816595,7,45,72,2007-05-25
Spectre,3,300000000,178416219,751916219,-121583781,451916219,131.607401295,20.1476642612,18.2019964853,57,64,66,2015-11-06
The Dark Knight Rises,4,275000000,448139099,1084439099,173139099,809439099,128.775478845,20.6397639393,19.7426510143,81,87,90,2012-07-20
The Lone Ranger,5,275000000,89289910,259989910,-185710090,-15010090,128.775478845,18.3740099285,16.6024477844,44,31,51,2013-07-03
John Carter,6,275000000,73058679,282778100,-201941321,7778100,128.775478845,18.5881284143,-4.60517113966,100,51,60,2012-03-09
Tangled,7,260000000,200821936,586581936,-59178064,326581936,126.982343247,19.8955173842,18.7766982709,74,90,87,2010-11-24
Spider-Man 3,8,258000000,336530303,890875303,78530303,632875303,126.737438842,20.4266446561,19.4519831156,42,63,51,2007-05-04
The Avengers: Age of Ultron,9,250000000,459005868,1404705868,209005868,1154705868,125.743342968,20.9584613586,19.8339752703,29,0,0,
The Hobbit: An Unexpected Journey,10,250000000,303003568,1017003568,53003568,767003568,125.743342968,20.5925348738,19.3565579582,56,0,0,
Harry Potter and the Half-Blood Prince,11,250000000,301959197,935083686,51959197,685083686,125.743342968,20.4945240548,19.3524530869,81,0,0,
The Hobbit: The Desolation of Smaug,12,250000000,258366855,960366855,8366855,710366855,125.743342968,20.5258108619,19.1640845178,88,0,0,
The Hobbit: The Battle of the Five Armies,13,250000000,255119788,955119788,5119788,705119788,125.743342968,20.51939785,19.1485245203,92,0,0,
Pirates of the Caribbean: On Stranger Tides,14,250000000,241063875,1045663875,-8936125,795663875,125.743342968,20.624675813,19.0782276688,23,0,0,
Superman Returns,15,232000000,200120000,374085065,-31880000,142085065,123.41615053,19.3470616266,18.9516696418,10,0,0,
Quantum of Solace,16,230000000,169368427,591692078,-60631573,361692078,123.149303238,19.9727910235,18.7664648333,57,0,0,
Pirates of the Caribbean: Dead Man's Chest,18,225000000,423315812,1066215812,198315812,841215812,122.474487139,20.6737247476,19.8076177311,9,0,0,
Man of Steel,19,225000000,291045518,667999518,66045518,442999518,122.474487139,20.1316815382,19.4064484291,6,0,0,
The Chronicles of Narnia: Prince Caspian,20,225000000,141621490,417341288,-83378510,192341288,122.474487139,19.5285551069,18.5909534288,5,0,0,
The Amazing Spider-Man,21,220000000,262030663,757890267,42030663,537890267,121.788328563,20.2899265932,19.312563957,29,0,0,
Jurassic World,22,215000000,652198010,1669164161,437198010,1454164161,121.090372444,21.1709052427,20.275633034,64,0,0,
Men in Black 3,23,215000000,179020854,654213485,-35979146,439213485,121.090372444,20.1248172438,18.927270459,14,0,0,
Transformers: Revenge of the Fallen,24,210000000,402111870,836519699,192111870,626519699,120.38013435,20.4180576637,19.7919964607,88,0,0,
Transformers: Age of Extinction,25,210000000,245439076,1104039076,35439076,894039076,120.38013435,20.727745108,19.2851744631,60,0,0,
X-Men: The Last Stand,26,210000000,234362462,459359555,24362462,249359555,120.38013435,19.7010861082,19.2373888273,30,0,0,
Robin Hood,27,210000000,105269730,322241588,-104730270,112241588,120.38013435,19.2212994455,18.3923949565,64,0,0,
Battleship,28,209000000,65233400,305218228,-143766600,96218228,120.236568043,19.1466264732,17.8789614714,54,0,0,
The Golden Compass,30,205000000,70107728,367262558,-134892272,162262558,119.657097839,19.4239297848,18.0209349843,35,0,0,
Titanic,31,200000000,658672302,2207615668,458672302,2007615668,118.9207115,21.4737692026,20.3086796929,81,0,0,
Toy Story 3,32,200000000,415004880,1069818229,215004880,869818229,118.9207115,20.7033370421,19.8484677571,56,0,0,
Iron Man 3,33,200000000,408992272,1215392272,208992272,1015392272,118.9207115,20.8417974937,19.8339421852,58,0,0,
Spider-Man 2,34,200000000,373524485,783705001,173524485,583705001,118.9207115,20.3582061866,19.7436779625,52,0,0,
Skyfall,36,200000000,304360277,1110526981,104360277,910526981,118.9207115,20.7440260674,19.5400807889,94,0,0,
Monsters University,37,200000000,268488329,743588329,68488329,543588329,118.9207115,20.2986768848,19.4155225485,82,0,0,
Oz the Great and Powerful,38,200000000,234770996,489570996,34770996,289570996,118.9207115,19.8070281987,19.2823561095,91,0,0,
X-Men: Days of Future Past,39,200000000,233921534,748121534,33921534,548121534,118.9207115,20.3055840725,19.2787610712,34,0,0,
The Amazing Spider-Man 2,40,200000000,202853933,708996336,2853933,508996336,118.9207115,20.2443370213,19.1375212771,25,0,0,
Cars 2,41,200000000,191450875,560155383,-8549125,360155383,118.9207115,19.969530987,19.0802307886,76,0,0,
Tron: Legacy,42,200000000,172062763,397562763,-27937237,197562763,118.9207115,19.5456525641,18.9745893282,54,0,0,
2012,43,200000000,166112167,788408539,-33887833,588408539,118.9207115,20.3649592498,18.9397928677,19,0,0,
Terminator Salvation,44,200000000,125322469,365491792,-74677531,165491792,118.9207115,19.4357013799,18.661772577,92,0,0,
Green Lantern,45,200000000,116601172,231201172,-83398828,31201172,118.9207115,18.7688797666,18.5907820451,17,0,0,
Prince of Persia: Sands of Time,46,200000000,90759676,314594597,-109240324,114594597,118.9207115,19.2318102248,18.3448897857,9,0,0,
Transformers: Dark of the Moon,49,195000000,352390543,1123790543,157390543,928790543,118.170385646,20.7617562691,19.6997569317,69,0,0,
Jack the Giant Slayer,50,195000000,65187603,197687603,-129812397,2687603,118.170385646,18.5441175006,18.093965687,0,0,0,
Furious 7,51,190000000,351032910,1516246709,161032910,1326246709,117.405488594,21.0856125318,19.7098424008,15,0,0,
Star Trek Into Darkness,52,190000000,228778661,466978661,38778661,276978661,117.405488594,19.7750429138,19.2991449156,57,0,0,
World War Z,53,190000000,202359711,531514650,12359711,341514650,117.405488594,19.9291150622,19.1828922762,2,0,0,
Disney's A Christmas Carol,55,190000000,137855863,315709697,-52144137,125709697,117.405488594,19.2800198411,18.8247928305,0,0,0,
Pacific Rim,56,190000000,101802906,411002906,-88197094,221002906,117.405488594,19.6189970243,18.5494628629,59,0,0,
The Good Dinosaur,57,187500000,59422070,88122070,-128077930,-99377930,117.017365966,16.2199581365,18.1177278777,38,0,0,
Iron Man,58,186000000,318604126,582443126,132604126,396443126,116.782625835,20.0438112199,19.6282832938,72,0,0,
The Dark Knight,59,185000000,533345358,1002891358,348345358,817891358,116.625342481,20.6489103265,20.125949935,5,0,0,
Indiana Jones and the Kingdom of the Crystal Skull,60,185000000,317023851,786558145,132023851,601558145,116.625342481,20.3836002488,19.6265472701,12,0,0,
Brave,61,185000000,237282182,554606532,52282182,369606532,116.625342481,19.9894149341,19.3537243712,24,0,0,
"The Chronicles of Narnia: The Lion, the Witch and the Wardrobe",62,180000000,291710957,720539572,111710957,540539572,115.829218529,20.2940045534,19.5637955354,12,0,0,
Maleficent,63,180000000,241407328,758407328,61407328,578407328,115.829218529,20.3505450877,19.3889893739,92,0,0,
WALL-E,64,180000000,223808164,532590994,43808164,352590994,115.829218529,19.9533266707,19.3198232214,45,0,0,
Rush Hour 3,65,180000000,140125968,256585882,-39874032,76585882,115.829218529,19.0468123327,18.9035221712,43,0,0,
Hugo,66,180000000,73864507,180047784,-106135493,47784,115.829218529,18.5205082146,18.3778340763,18,0,0,
Jupiter Ascending,68,179000000,47482519,181982519,-131517481,2982519,115.66800837,18.5467208053,18.0700424003,10,0,0,
Edge of Tomorrow,69,178000000,100206256,364406256,-77793744,186406256,115.506121328,19.5087594083,18.6369815531,60,0,0,
Inside Out,70,175000000,356418708,852343178,181418708,677343178,115.01633169,20.4847464561,19.7644851291,13,0,0,
Up,71,175000000,293004164,731542621,118004164,556542621,115.01633169,20.3182899037,19.5836611799,14,0,0,
Monsters vs. Aliens,72,175000000,198351526,381687380,23351526,206687380,115.01633169,19.5748463765,19.2329116562,30,0,0,
G.I. Joe: The Rise of Cobra,73,175000000,150201498,302469017,-24798502,127469017,115.01633169,19.2874419262,18.9924668522,94,0,0,
Wild Wild West,74,175000000,113805681,221229335,-61194319,46229335,115.01633169,18.8697133671,18.7624745247,32,0,0,
The Mummy: Tomb of the Dragon Emperor,75,175000000,102277510,405545959,-72722490,230545959,115.01633169,19.6473818945,18.6770178895,94,0,0,
Evan Almighty,76,175000000,100289690,174131329,-74710310,-868671,115.01633169,18.5121797706,18.6615149764,79,0,0,
Waterworld,77,175000000,88214660,264214660,-86785340,89214660,115.01633169,19.1121510294,18.5617981239,83,0,0,
47 Ronin,78,175000000,38362475,151659062,-136637525,-23340938,115.01633169,18.282674256,17.9945607244,16,0,0,
Guardians of the Galaxy,80,170000000,333172112,771172112,163172112,601172112,114.185834544,20.383057927,19.7157186386,51,0,0,
Iron Man 2,81,170000000,312128345,623256345,142128345,453256345,114.185834544,20.1500444383,19.6563547123,45,0,0,
Captain America: The Winter Soldier,82,170000000,259746958,713846958,89746958,543846958,114.185834544,20.2990722405,19.4911962524,76,0,0,
Dawn of the Planet of the Apes,83,170000000,208545589,703545589,38545589,533545589,114.185834544,20.2832028105,19.2981762178,21,0,0,
The Polar Express,84,170000000,194949659,319049659,24949659,149049659,114.185834544,19.3742668791,19.2399801958,35,0,0,
Snow White and the Huntsman,85,170000000,155136755,401016924,-14863245,231016924,114.185834544,19.648762086,19.0470366065,19,0,0,
Terminator 3: Rise of the Machines,86,170000000,150358296,433058296,-19641704,263058296,114.185834544,19.7384514217,19.0211621388,100,0,0,
Van Helsing,87,170000000,120150546,300150546,-49849454,130150546,114.185834544,19.2986496367,18.8399952845,7,0,0,
Tomorrowland,88,170000000,93436322,205336322,-76563678,35336322,114.185834544,18.7976542197,18.6468408849,66,0,0,
Shrek Forever After,89,165000000,238395990,755903876,73395990,590903876,113.336810343,20.3685234787,19.4335074895,36,0,0,
Big Hero 6,90,165000000,222527828,652127828,57527828,487127828,113.336810343,20.2083954943,19.3741483672,5,0,0,
How to Train Your Dragon,91,165000000,217581231,494870991,52581231,329870991,113.336810343,19.9030150935,19.354900003,40,0,0,
Wreck-It Ralph,92,165000000,189412677,473412677,24412677,308412677,113.336810343,19.8530542621,19.2376106946,35,0,0,
Interstellar,93,165000000,188017894,665417894,23017894,500417894,113.336810343,20.2303916772,19.2314296771,82,0,0,
Cowboys and Aliens,94,163000000,100240551,175910315,-62759449,12910315,112.991793219,18.6306219831,18.7512920676,0,0,0,
Shrek the Third,95,160000000,321012359,805623351,161012359,645623351,112.468265038,20.4436492747,19.7097857808,59,0,0,
Inception,96,160000000,292576195,832584416,132576195,672584416,112.468265038,20.4786875161,19.6281998009,93,0,0,
Fast and Furious 6,97,160000000,238679850,789952811,78679850,629952811,112.468265038,20.4227052621,19.4525161719,60,0,0,
The Hunger Games: Mockingjay - Part 2,98,160000000,206380154,448780154,46380154,288780154,112.468265038,19.8050492418,19.3302347349,46,0,0,
X-Men: First Class,100,160000000,146408305,355408305,-13591695,195408305,112.468265038,19.5386332884,19.0538105065,32,0,0,
The Curious Case of Benjamin Button,101,160000000,127509326,329809326,-32490674,169809326,112.468265038,19.4512267603,18.9480722743,74,0,0,
The Sorcerer's Apprentice,102,160000000,63150991,217986320,-96849009,57986320,112.468265038,18.9420697503,18.4703496839,42,0,0,
Poseidon,103,160000000,60674817,181674817,-99325183,21674817,112.468265038,18.6992594488,18.4465057689,72,0,0,
The Chronicles of Narnia: The Voyage of the Dawn Treader,104,155000000,104386950,418186950,-50613050,263186950,111.579118109,19.7387958097,18.8349620153,12,0,0,
Terminator: Genisys,105,155000000,89760956,440160956,-65239044,285160956,111.579118109,19.7959424637,18.7333159585,48,0,0,
Alexander,106,155000000,34297191,167297191,-120702809,12297191,111.579118109,18.6256394121,18.2128999785,65,0,0,
Pearl Harbor,107,151500000,198539855,449239855,47039855,297739855,110.943830947,19.8272435479,19.3328878532,55,0,0,
Transformers,108,151000000,319071806,708098205,168071806,557098205,110.852179624,20.3191225254,19.7290490414,42,0,0,
Frozen,109,150000000,400738009,1274234980,250738009,1124234980,110.66819197,20.9340818936,19.930694552,10,0,0,
Harry Potter and the Order of the Phoenix,110,150000000,292004738,942943935,142004738,792943935,110.66819197,20.6216695355,19.6559953978,37,0,0,
Harry Potter and the Goblet of Fire,111,150000000,290013036,896911078,140013036,746911078,110.66819197,20.569369998,19.6501878271,59,0,0,
The Matrix Reloaded,112,150000000,281553689,738576929,131553689,588576929,110.66819197,20.3652001707,19.6251384607,3,0,0,
I am Legend,113,150000000,256393010,585532684,106393010,435532684,110.66819197,20.1180982622,19.5466952425,75,0,0,
Hancock,114,150000000,227946274,624234272,77946274,474234272,110.66819197,20.1865829674,19.4498986341,40,0,0,
Charlie and the Chocolate Factory,115,150000000,206459076,475825484,56459076,325825484,110.66819197,19.8937850005,19.3700208663,100,0,0,
Ratatouille,116,150000000,206445654,626549695,56445654,476549695,110.66819197,20.1905352705,19.3699689223,42,0,0,
Thor: The Dark World,117,150000000,206360018,633360018,56360018,483360018,110.66819197,20.2020703987,19.369637442,4,0,0,
Batman Begins,118,150000000,205343774,359142722,55343774,209142722,110.66819197,19.5825587566,19.3656953471,87,0,0,
Mission: Impossible - Rogue Nation,119,150000000,195042377,700868363,45042377,550868363,110.66819197,20.3097462862,19.3248328925,35,0,0,
Thor,120,150000000,181030624,449326618,31030624,299326618,110.66819197,19.8311233256,19.2664285966,74,0,0,
Madagascar: Escape 2 Africa,121,150000000,180010950,599516844,30010950,449516844,110.66819197,20.143388565,19.2620421801,72,0,0,
X-Men Origins: Wolverine,122,150000000,179883157,374825760,29883157,224825760,110.66819197,19.6304646372,19.261491083,52,0,0,
Night at the Museum: Battle of the Smithsonian,123,150000000,177243721,402231063,27243721,252231063,110.66819197,19.709035059,19.2500402789,77,0,0,
Kung Fu Panda 2,124,150000000,165249063,664837547,15249063,514837547,110.66819197,20.2537225641,19.1962848725,37,0,0,
Mad Max: Fury Road,125,150000000,153636354,373136354,3636354,223136354,110.66819197,19.6254130478,19.1413345011,65,0,0,
The Matrix Revolutions,126,150000000,139259759,427289109,-10740241,277289109,110.66819197,19.7758438961,19.0688362072,4,0,0,
Mission: Impossible III,127,150000000,133501348,397501348,-16498652,247501348,110.66819197,19.6959083118,19.0382563303,72,0,0,
Angels & Demons,128,150000000,133375846,490875846,-16624154,340875846,110.66819197,19.9277006695,19.0375793314,82,0,0,
Troy,129,150000000,133298577,484161265,-16701423,334161265,110.66819197,19.9127114409,19.037162289,81,0,0,
The Last Airbender,130,150000000,131601062,319542756,-18398938,169542756,110.66819197,19.4502751537,19.0279561689,93,0,0,
Bee Movie,131,150000000,126631277,287594577,-23368723,137594577,110.66819197,19.3291200096,19.000505788,7,0,0,
G-Force,132,150000000,119436770,292817841,-30563230,142817841,110.66819197,19.3499591023,18.9593827322,77,0,0,
Bolt,133,150000000,114053759,328015209,-35946241,178015209,110.66819197,19.4800858829,18.9274687074,34,0,0,
Wrath of the Titans,134,150000000,83670083,305270083,-66329917,155270083,110.66819197,19.3979549039,18.7253040303,2,0,0,
Beowulf,135,150000000,82195215,194995215,-67804785,44995215,110.66819197,18.8618054693,18.7143687646,100,0,0,
Dark Shadows,136,150000000,79727149,236527149,-70272851,86527149,110.66819197,19.0985995137,18.6957977304,85,0,0,
White House Down,137,150000000,73103784,205440387,-76896216,55440387,110.66819197,18.9268392678,18.6441850703,14,0,0,
The Wolfman,138,150000000,61979680,142424154,-88020320,-7575846,110.66819197,18.4490193458,18.5510157925,32,0,0,
Pan,139,150000000,34570824,123370824,-115429176,-26629176,110.66819197,18.2441949182,18.2757953668,8,0,0,
Mars Needs Moms,140,150000000,21392758,39549758,-128607242,-110450242,110.66819197,-4.60516964955,18.1105359839,62,0,0,
Batman Begins (IMAX),141,150000000,15900000,169698948,-134100000,19698948,110.66819197,18.6841919659,18.0326820217,95,0,0,
Flushed Away,143,149000000,64665672,179357126,-84334328,30357126,110.483282064,18.7629033299,18.582859056,35,0,0,
Madagascar 3: Europe's Most Wanted,144,145000000,216391482,746921271,71391482,601921271,109.734199677,20.3841101212,19.4262006693,65,0,0,
Mission: Impossible - Ghost Protocol,145,145000000,209397903,694713230,64397903,549713230,109.734199677,20.3079980472,19.4002813325,97,0,0,
How to Train Your Dragon 2,146,145000000,177002924,616102924,32002924,471102924,109.734199677,20.1812129548,19.2705933757,86,0,0,
Tarzan,147,145000000,171091819,448191819,26091819,303191819,109.734199677,19.8405115709,19.2450015273,75,0,0,
Mr. Peabody & Sherman,148,145000000,111506430,269806430,-33493570,124806430,109.734199677,19.2761876974,18.9421361766,66,0,0,
Rise of the Guardians,149,145000000,103412758,306900902,-41587242,161900902,109.734199677,19.4226027623,18.8928949219,75,0,0,
Sahara,150,145000000,68671925,121671925,-76328075,-23328075,109.734199677,18.2828219101,18.6487182683,99,0,0,
Die Another Day,151,142000000,160932247,431932247,18932247,289932247,109.162151352,19.8079308707,19.2131010053,82,0,0,
Star Trek,152,140000000,257730019,385680446,117730019,245680446,108.775730594,19.6908083226,19.5828039635,73,0,0,
Armageddon,153,140000000,201573391,554595209,61573391,414595209,108.775730594,20.0789953902,19.3896197574,2,0,0,
Men in Black 2,154,140000000,190418803,441767803,50418803,301767803,108.775730594,19.8370630028,19.3463676889,91,0,0,
Captain America: The First Avenger,155,140000000,176654505,370569776,36654505,230569776,108.775730594,19.6474517374,19.2902815738,36,0,0,
Lethal Weapon 4,156,140000000,129734803,284690200,-10265197,144690200,108.775730594,19.3573247045,19.0713176515,79,0,0,
G.I. Joe: Retaliation,157,140000000,122523060,371923060,-17476940,231923060,108.775730594,19.6514122261,19.032966946,96,0,0,
The Last Samurai,158,140000000,111110575,456810575,-28889425,316810575,108.775730594,19.8729051974,18.9691020844,6,0,0,
Fun With Dick And Jane,159,140000000,110550000,203018919,-29450000,63018919,108.775730594,18.9715103952,18.9658574802,39,0,0,
Exodus: Gods and Kings,160,140000000,65014513,268314513,-74985487,128314513,108.775730594,19.2909893365,18.6593498202,39,0,0,
Spider-Man,161,139000000,403706375,821706375,264706375,682706375,108.580965747,20.4915312595,19.9610851327,28,0,0,
Watchmen,162,138000000,107509799,184068357,-30490201,46068357,108.385147158,18.8686854044,18.9598087694,17,0,0,
Stealth,163,138000000,31704416,76004416,-106295584,-61995584,108.385147158,17.6961390322,18.3761616842,13,0,0,
The Incredible Hulk,164,137500000,134533885,263144885,-2966115,125644885,108.286838533,19.2797453623,19.108690782,37,0,0,
Hulk,165,137000000,132177234,245229234,-4822766,108229234,108.188261428,19.2031176358,19.0993159078,86,0,0,
Final Fantasy: The Spirits Within,166,137000000,32131830,85131830,-104868170,-51868170,108.188261428,17.8859392693,18.3909753864,88,0,0,
"The Twilight Saga: Breaking Dawn, Part 2",167,136200000,292324737,829724737,156124737,693524737,108.029975325,20.505078706,19.6962280469,42,0,0,
The Croods,168,135000000,187168425,573068425,52168425,438068425,107.791233589,20.1227318699,19.3532768026,73,0,0,
The World is Not Enough,169,135000000,126930660,361730660,-8069340,226730660,107.791233589,19.6361301455,19.0827086075,52,0,0,
Rango,170,135000000,123257581,245504574,-11742419,110504574,107.791233589,19.2134687861,19.0635809352,70,0,0,
Master and Commander: The Far Side of the World,171,135000000,93926386,212912137,-41073614,77912137,107.791233589,19.0538782134,18.8960928896,36,0,0,
Turbo,172,135000000,83028130,286896578,-51971870,151896578,107.791233589,19.3851779268,18.8259421714,16,0,0,
Happy Feet Two,173,135000000,64006466,157956466,-70993534,22956466,107.791233589,18.7089129751,18.6903092293,43,0,0,
Miami Vice,174,135000000,63450470,163790188,-71549530,28790188,107.791233589,18.7517127092,18.6860542531,3,0,0,
War of the Worlds,175,132000000,234280354,606836535,102280354,474836535,107.187337373,20.1876125022,19.5332671877,25,0,0,
Penguins of Madagascar,176,132000000,83350911,367650911,-48649089,235650911,107.187337373,19.66224164,18.8478566707,44,0,0,
The Hunger Games: Catching Fire,177,130000000,424668047,864868047,294668047,734868047,106.778997237,20.5552237878,20.0233142952,91,0,0,
Harry Potter and the Prisoner of Azkaban,178,130000000,249538952,796688549,119538952,666688549,106.778997237,20.4711295166,19.5884467405,26,0,0,
The Bourne Ultimatum,179,130000000,227471070,442161562,97471070,312161562,106.778997237,19.8619645946,19.5173324152,48,0,0,
Kung Fu Panda,180,130000000,215434591,631910531,85434591,501910531,106.778997237,20.2328321652,19.4763017146,38,0,0,
Ant-Man,181,130000000,180070613,518470613,50070613,388470613,106.778997237,20.0279580339,19.3449870015,19,0,0,
Puss in Boots,183,130000000,149260504,554987477,19260504,424987477,106.778997237,20.0985951367,19.2145860781,66,0,0,
Megamind,184,130000000,148415853,321887208,18415853,191887208,106.778997237,19.5270543357,19.2107603061,29,0,0,
Bad Boys II,185,130000000,138540870,272940870,8540870,142940870,106.778997237,19.3504447503,19.1649116042,34,0,0,
Rio 2,186,130000000,131538435,493738435,1538435,363738435,106.778997237,19.9771158532,19.1310770788,48,0,0,
Salt,187,130000000,118311368,290650494,-11688632,160650494,106.778997237,19.4180010294,19.0638636887,38,0,0,
Noah,188,130000000,101200044,352831065,-28799956,222831065,106.778997237,19.6244974571,18.9696189576,27,0,0,
The Adventures of Tintin,189,130000000,77591831,373993951,-52408169,243993951,106.778997237,19.686061467,18.8230286788,7,0,0,
After Earth,190,130000000,60522097,251499665,-69477903,121499665,106.778997237,19.2620319883,18.7018170748,67,0,0,
Australia,191,130000000,49554002,215080810,-80445998,85080810,106.778997237,19.0912297586,18.6153863263,57,0,0,
R.I.P.D.,192,130000000,33618855,79072464,-96381145,-50927536,106.778997237,17.9018684113,18.474791737,85,0,0,
"The Twilight Saga: Breaking Dawn, Part 1",193,127500000,281287133,689420051,153787133,561920051,106.261892467,20.326319778,19.6896782281,0,0,0,
Dinosaur,194,127500000,137748063,356148063,10248063,228648063,106.261892467,19.6418006086,19.1729897547,54,0,0,
Night at the Museum: Secret of the Tomb,195,127000000,113746621,356546621,-13253379,229546621,106.157560586,19.6444469491,19.055605108,42,0,0,
Harry Potter and the Deathly Hallows: Part II,196,125000000,381011219,1341511219,256011219,1216511219,105.737126344,21.0061575497,19.9422761123,45,0,0,
The Hunger Games: Mockingjay - Part 1,197,125000000,337135885,709635885,212135885,584635885,105.737126344,20.3595463196,19.8415630023,65,0,0,
Harry Potter and the Sorcerers Stone,198,125000000,317575550,974755371,192575550,849755371,105.737126344,20.6826579997,19.7931724629,54,0,0,
Pirates of the Caribbean: The Curse of the Black Pearl,199,125000000,305411224,634954103,180411224,509954103,105.737126344,20.2458819928,19.7618536337,18,0,0,
Harry Potter and the Deathly Hallows: Part I,200,125000000,295001070,959301070,170001070,834301070,105.737126344,20.6664322889,19.7342495374,100,0,0,
The Da Vinci Code,201,125000000,217536138,767820459,92536138,642820459,105.737126344,20.4399352179,19.5007130183,62,0,0,
X2,202,125000000,214949694,407711549,89949694,282711549,105.737126344,19.7897317671,19.4918910543,72,0,0,
Fast Five,203,125000000,209837675,629969804,84837675,504969804,105.737126344,20.2378155943,19.4742224283,4,0,0,
Sherlock Holmes: A Game of Shadows,205,125000000,186848418,535663443,61848418,410663443,105.737126344,20.0714787813,19.3906629006,70,0,0,
The Day After Tomorrow,206,125000000,186740799,556319450,61740799,431319450,105.737126344,20.1103515466,19.3902548447,100,0,0,
Godzilla,208,125000000,136142003,375827709,11142003,250827709,105.737126344,19.7051581674,19.1771938397,34,0,0,
Prometheus,209,125000000,126477084,399005706,1477084,274005706,105.737126344,19.7673397708,19.1307755243,9,0,0,
The Bourne Legacy,210,125000000,113203870,280355920,-11796130,155355920,105.737126344,19.3982778869,19.0632985015,83,0,0,
Batman & Robin,211,125000000,107308328,238300947,-17691672,113300947,105.737126344,19.2260452291,19.0318021841,91,0,0,
The 13th Warrior,213,125000000,32694788,61694788,-92305212,-63305212,105.737126344,17.6687391534,18.51267734,57,0,0,
How the Grinch Stole Christmas,214,123000000,260044825,345141403,137044825,222141403,105.311616199,19.6224260042,19.6414697973,90,0,0,
Mission: Impossible 2,215,120000000,215409889,549588516,95409889,429588516,104.663513939,20.107151469,19.5104245234,30,0,0,
The Perfect Storm,216,120000000,182618434,328711434,62618434,208711434,104.663513939,19.5812083537,19.3935777006,28,0,0,
Fantastic Four: Rise of the Silver Surfer,217,120000000,131921738,288215319,11921738,168215319,104.663513939,19.4455229147,19.180846457,42,0,0,
Life of Pi,218,120000000,124987022,607987022,4987022,487987022,104.663513939,20.2098322554,19.1478831223,37,0,0,
Ghost Rider,219,120000000,115802596,229545589,-4197404,109545589,104.663513939,19.2091191542,19.1024834031,100,0,0,
Charlie's Angels: Full Throttle,220,120000000,100814328,227200000,-19185672,107200000,104.663513939,19.1983999379,19.0236605673,3,0,0,
Elysium,221,120000000,93050117,286192091,-26949883,166192091,104.663513939,19.4382360132,18.980247605,72,0,0,
Oblivion,222,120000000,89107235,287916633,-30892765,167916633,104.663513939,19.4444504959,18.9574580274,34,0,0,
Stuart Little 2,223,120000000,64736114,165779308,-55263886,45779308,104.663513939,18.8668369581,18.803746414,83,0,0,
The Chronicles of Riddick,225,120000000,57712751,107212751,-62287249,-12787249,104.663513939,18.3970332634,18.7546790086,21,0,0,
Speed Racer,227,120000000,43945766,93394462,-76054234,-26605538,104.663513939,18.244476884,18.6508959283,57,0,0,
How Do You Know?,229,120000000,30212620,49628177,-89787380,-70371823,104.663513939,17.5063485681,18.5353829588,75,0,0,
Knight and Day,231,117000000,76423035,258751370,-40576965,141751370,104.003143349,19.3457393733,18.8991754468,8,0,0,
Star Wars Ep. I: The Phantom Menace,232,115000000,474544677,1027044677,359544677,912044677,103.555807634,20.7455114767,20.1460973951,52,0,0,
Star Wars Ep. III: Revenge of the Sith,233,115000000,380270577,848998877,265270577,733998877,103.555807634,20.5541950426,19.9622934558,36,0,0,
Star Wars Ep. II: Attack of the Clones,234,115000000,302181125,648200000,187181125,533200000,103.555807634,20.2826660341,19.7794046233,23,0,0,
"Monsters, Inc.",235,115000000,289423425,559757719,174423425,444757719,103.555807634,20.134853306,19.7460693003,99,0,0,
The Wolverine,236,115000000,132556852,416456852,17556852,301456852,103.555807634,19.8363083819,19.206854467,43,0,0,
Dante's Peak,237,115000000,67155742,178191885,-47844258,63191885,103.555807634,18.9725069979,18.8530932411,18,0,0,
Windtalkers,238,115000000,40914068,77628265,-74085932,-37371735,103.555807634,18.1070448597,18.6664104098,78,0,0,
Astérix aux Jeux Olympiques,239,113500000,999811,132999811,-112500189,19499811,103.216461266,18.682660727,18.3090912239,78,0,0,
Gulliver's Travels,240,112000000,42779261,232017848,-69220739,120017848,102.873734472,19.2556229727,18.7037565891,68,0,0,
Gravity,241,110000000,274092705,716392705,164092705,606392705,102.411368908,20.3903673327,19.7182368543,37,0,0,
Night at the Museum,242,110000000,250863268,581570293,140863268,471570293,102.411368908,20.1820162886,19.6526711314,78,0,0,
Mr. and Mrs. Smith,243,110000000,186336279,486124090,76336279,376124090,102.411368908,20.0029002373,19.4441297346,2,0,0,
San Andreas,244,110000000,155190832,469590832,45190832,359590832,102.411368908,19.9683306404,19.3254337839,92,0,0,
The Smurfs,245,110000000,142614158,563749323,32614158,453749323,102.411368908,20.1509185855,19.2732027021,85,0,0,
Live Free or Die Hard,246,110000000,134529403,382288147,24529403,272288147,102.411368908,19.7628622563,19.2381262407,79,0,0,
Insurgent,247,110000000,130179072,295279072,20179072,185279072,102.411368908,19.5049551142,19.2187301037,44,0,0,
Ocean's Twelve,248,110000000,125531634,362989076,15531634,252989076,102.411368908,19.7111229029,19.197585056,39,0,0,
Tomorrow Never Dies,249,110000000,125279326,339479326,15279326,229479326,102.411368908,19.6442490012,19.1964242014,66,0,0,
The Patriot,250,110000000,113330342,215300000,3330342,105300000,102.411368908,19.1896320096,19.1398448452,24,0,0,
300: Rise of an Empire,251,110000000,106580051,330780051,-3419949,220780051,102.411368908,19.6183244407,19.1064073199,78,0,0,
The Aviator,252,110000000,102608827,208370892,-7391173,98370892,102.411368908,19.1569886254,19.0862005182,65,0,0,
The Green Hornet,253,110000000,98780042,229155503,-11219958,119155503,102.411368908,19.2518742439,19.0663240885,41,0,0,
Real Steel,254,110000000,85463309,263880341,-24536691,153880341,102.411368908,19.3927110861,18.9939437268,97,0,0,
The A-Team,255,110000000,77222099,177241171,-32777901,67241171,102.411368908,18.995558969,18.946375788,8,0,0,
The Smurfs 2,256,110000000,71017784,348547523,-38982216,238547523,102.411368908,19.6705760762,18.9090098378,28,0,0,
The Taking of Pelham 123,257,110000000,65452312,152364370,-44547688,42364370,102.411368908,18.8447360585,18.8742604421,13,0,0,
Ender's Game,258,110000000,61737191,89737191,-48262809,-20262809,102.411368908,18.3174006517,18.850373394,51,0,0,
Home on the Range,259,110000000,50026353,76482461,-59973647,-33517539,102.411368908,18.1584416108,18.7711099418,10,0,0,
Speed II: Cruise Control,260,110000000,48068396,150439315,-61931604,40439315,102.411368908,18.8320587166,18.7572223854,55,0,0,
Kingdom of Heaven,261,110000000,47398413,218853353,-62601587,108853353,102.411368908,19.2059676064,18.7524256386,38,0,0,
The Lord of the Rings: The Fellowship of the Ring,263,109000000,315544750,887217688,206544750,778217688,102.177818086,20.6052341917,19.8279683738,9,0,0,
The Cat in the Hat,264,109000000,101018283,133818283,-7981717,24818283,102.177818086,18.722772435,19.0831604686,73,0,0,
Ali,265,109000000,58183966,87683966,-50816034,-21316034,102.177818086,18.305653747,18.8336197661,13,0,0,
The Martian,266,108000000,219047062,559911261,111047062,451911261,101.942654691,20.1476554449,19.5616766328,85,0,0,
"I, Robot",267,105000000,144795350,348623912,39795350,243623912,101.227223443,19.6850169238,19.3033595553,49,0,0,
Stuart Little,268,105000000,140015224,298815224,35015224,193815224,101.227223443,19.5334111218,19.2833873279,99,0,0,
The Princess and the Frog,269,105000000,104400899,270997378,-599101,165997378,101.227223443,19.4375319216,19.1205166054,0,0,0,
"10,000 B.C.",270,105000000,94784201,269065678,-10215799,164065678,101.227223443,19.4305198136,19.0715753343,7,0,0,
Town & Country,271,105000000,6712451,10364769,-98287549,-94635231,101.227223443,16.5764701109,18.456566788,27,0,0,
Gone in 60 Seconds,272,103300000,101643008,232643008,-1656992,129343008,100.814982804,19.2952876517,19.11524856,10,0,0,
Gladiator,273,103000000,187683805,457683805,84683805,354683805,100.741707178,19.9578361951,19.4736857388,12,0,0,
The Hangover 3,274,103000000,112200072,362000072,9200072,259000072,100.741707178,19.7275268211,19.1680385761,30,0,0,
Public Enemies,275,102500000,97104620,212282709,-5395380,109782709,100.619224633,19.2101964123,19.0964067584,93,0,0,
Minority Report,277,102000000,132024714,358824714,30024714,256824714,100.496293157,19.7216213244,19.2621015181,13,0,0,
Cloud Atlas,278,102000000,27108272,130673154,-74891728,28673154,100.496293157,18.7508718384,18.6600880643,12,0,0,
Harry Potter and the Chamber of Secrets,279,100000000,261987880,878979634,161987880,778979634,100.0,20.6060912267,19.712469904,50,0,0,
Terminator 2: Judgment Day,280,100000000,201858746,513815401,101858746,413815401,100.0,20.0775090661,19.5318803687,22,0,0,
Batman Forever,281,100000000,183997904,336495936,83997904,236495936,100.0,19.6646802193,19.4712898462,91,0,0,
Planet of the Apes,282,100000000,180011740,362211740,80011740,262211740,100.0,19.7361823523,19.4572511647,86,0,0,
National Treasure,283,100000000,173005002,331323410,73005002,231323410,100.0,19.6496592397,19.4320864475,47,0,0,
Django Unchained,284,100000000,162805434,425373688,62805434,325373688,100.0,19.8927488895,19.3942842856,46,0,0,
Little Fockers,285,100000000,148438600,310650574,48438600,210650574,100.0,19.5872657004,19.3384900063,37,0,0,
True Lies,286,100000000,146273950,365291539,46273950,265291539,100.0,19.7444127128,19.3298069559,27,0,0,
American Gangster,287,100000000,130164645,267985456,30164645,167985456,100.0,19.4446977038,19.2627045754,76,0,0,
Cloudy with a Chance of Meatballs,288,100000000,124870275,236827677,24870275,136827677,100.0,19.3260234402,19.2396302573,60,0,0,
The Other Guys,289,100000000,119219978,170936470,19219978,70936470,100.0,19.0161418405,19.214402853,48,0,0,
Lemony Snicket's A Series of Unfortunate Events,290,100000000,118627117,212956024,18627117,112956024,100.0,19.2245024926,19.2117185812,68,0,0,
The Wolf of Wall Street,291,100000000,116900694,391976723,16900694,291976723,100.0,19.813024185,19.2038606348,8,0,0,
Epic,292,100000000,107518682,262794441,7518682,162794441,100.0,19.4258782265,19.1600433627,7,0,0,
Eraser,293,100000000,101283031,234387469,1283031,134387469,100.0,19.316106145,19.1298211091,56,0,0,
The Hunchback of Notre Dame,294,100000000,100117603,325478752,117603,225478752,100.0,19.6324103682,19.1240699158,88,0,0,
The Emperor's New Groove,295,100000000,89296573,169296573,-10703427,69296573,100.0,19.0070598354,19.0690287294,69,0,0,
The Expendables 2,296,100000000,85028192,311979256,-14971808,211979256,100.0,19.5913950595,19.0464561295,100,0,0,
Where the Wild Things Are,297,100000000,77233467,99123656,-22766533,-876344,100.0,18.5121097473,19.0038723567,6,0,0,
Eragon,298,100000000,75030163,249488115,-24969837,149488115,100.0,19.3759550724,18.9914991703,53,0,0,
The Tourist,300,100000000,67631157,278731369,-32368843,178731369,100.0,19.4825654605,18.9487909923,77,0,0,
End of Days,301,100000000,66889043,212026975,-33110957,112026975,100.0,19.2203352589,18.9444050055,72,0,0,
The Stepford Wives,302,100000000,59475623,96221971,-40524377,-3778029,100.0,18.4852712607,18.8995012898,92,0,0,
Surf's Up,303,100000000,58867694,145395745,-41132306,45395745,100.0,18.8643788148,18.8957279766,74,0,0,
Blood Diamond,304,100000000,57377916,171377916,-42622084,71377916,100.0,19.0185726123,18.8864205272,61,0,0,
Legend of the Guardians: The Owls of Ga'Hoole,305,100000000,55675313,139716717,-44324687,39716717,100.0,18.8272582931,18.8756762756,70,0,0,
Starship Troopers,306,100000000,54700065,121031113,-45299935,21031113,100.0,18.6943756125,18.8694695851,73,0,0,
Land of the Lost,307,100000000,49438370,69548641,-50561630,-30451359,100.0,18.1975232302,18.8353017487,37,0,0,
Catwoman,309,100000000,40202379,82145379,-59797621,-17854621,100.0,18.3437524092,18.7723490758,0,0,0,
The Expendables 3,310,100000000,39322544,209461378,-60677456,109461378,100.0,19.2087362964,18.7661400825,30,0,0,
Treasure Planet,311,100000000,38120554,91800000,-61879446,-8200000,100.0,18.4429337197,18.7575948473,49,0,0,
Green Zone,312,100000000,35053660,97079343,-64946340,-2920657,100.0,18.4932765771,18.7354548482,74,0,0,
Transcendence,313,100000000,23022309,103039258,-76977691,3039258,100.0,18.5472208797,18.643533293,32,0,0,
Son of the Mask,314,100000000,17018422,59918422,-82981578,-40081578,100.0,18.0692586085,18.5942956998,95,0,0,
The Spanish Prisoner,315,100000000,10162034,13835130,-89837966,-86164870,100.0,17.0053847522,18.5349318163,55,0,0,
The Adventures of Pluto Nash,316,100000000,4411102,7094995,-95588898,-92905005,100.0,16.6802930756,18.4822688827,27,0,0,
Jin líng shí san chai,317,100000000,311434,93721434,-99688566,-6278566,100.0,18.461550827,18.4429582964,49,0,0,
The Peanuts Movie,319,99000000,117674348,127474348,18674348,28474348,99.7490569934,18.749441826,19.2119326913,83,0,0,
The Mummy Returns,320,98000000,202007640,435040395,104007640,337040395,99.4962056393,19.9191661726,19.5389288519,28,0,0,
Gangs of New York,321,97000000,77730500,183124621,-19269500,86124621,99.2414117281,19.096553899,19.0232017731,85,0,0,
Ice Age: Continental Drift,324,95000000,161321843,879765137,66321843,784765137,98.7258544901,20.6125748942,19.4074790119,38,0,0,
Black Hawk Down,325,95000000,108638745,159691085,13638745,64691085,98.7258544901,18.9811037889,19.1888429345,88,0,0,
Sex and the City 2,326,95000000,95347692,294680778,347692,199680778,98.7258544901,19.5525054113,19.1252079903,56,0,0,
Percy Jackson & the Olympians: The Lightning Thief,327,95000000,88768303,223050874,-6231697,128050874,98.7258544901,19.2898845476,19.0921426085,8,0,0,
The Campaign,328,95000000,86907746,104907746,-8092254,9907746,98.7258544901,18.6059810932,19.0825904091,12,0,0,
Unstoppable,329,95000000,81562942,169511609,-13437058,74511609,98.7258544901,19.035660151,19.05463118,66,0,0,
The Fifth Element,330,95000000,63540020,263869158,-31459980,168869158,98.7258544901,19.4478664879,18.9541364118,19,0,0,
The Road to El Dorado,331,95000000,50802661,65700000,-44197339,-29300000,98.7258544901,18.2118128342,18.8764839098,19,0,0,
The Lovely Bones,332,95000000,44028238,94808454,-50971762,-191546,98.7258544901,18.5183399446,18.8325887785,70,0,0,
Seventh Son,333,95000000,17223265,110623265,-77776735,15623265,98.7258544901,18.6523756838,18.63711855,73,0,0,
Finding Nemo,334,94000000,380529370,936429370,286529370,842429370,98.4650177212,20.6749991284,20.0067900297,36,0,0,
The Lord of the Rings: The Return of the King,335,94000000,377845905,1141408667,283845905,1047408667,98.4650177212,20.8698383684,20.0012812794,19,0,0,
The Lord of the Rings: The Two Towers,336,94000000,342548984,934703179,248548984,840703179,98.4650177212,20.6731859335,19.9258471143,41,0,0,
Lara Croft: Tomb Raider,337,94000000,131144183,273330185,37144183,179330185,98.4650177212,19.4846340459,19.2923318033,71,0,0,
Jurassic Park III,338,93000000,181166115,365900000,88166115,272900000,98.2020914288,19.7644595993,19.4857618813,49,0,0,
Rise of the Planet of the Apes,339,93000000,176760185,482860185,83760185,389860185,98.2020914288,20.0307393178,19.4704581385,67,0,0,
The Spiderwick Chronicles,340,92500000,71195053,162839667,-21304947,70339667,98.0698324197,19.0128461914,19.0119965851,53,0,0,
The Incredibles,341,92000000,261441092,614726752,169441092,522726752,97.9370361336,20.2662605524,19.7327428525,27,0,0,
A Good Day to Die Hard,342,92000000,67349198,304249198,-24650802,212249198,97.9370361336,19.5922319217,18.9933002953,23,0,0,
Cutthroat Island,344,92000000,9833397,18333397,-82166603,-73666603,97.9370361336,17.4205637122,18.6011231864,39,0,0,
The Secret Life of Walter Mitty,345,91000000,58236838,188536838,-32763162,97536838,97.669811171,19.1529865204,18.9464629129,35,0,0,
Men in Black,346,90000000,250147615,587247615,160147615,497247615,97.4003746425,20.2251883707,19.7074004192,38,0,0,
Toy Story 2,347,90000000,245823397,511329494,155823397,421329494,97.4003746425,20.0917399315,19.695386116,36,0,0,
Rush Hour 2,348,90000000,226164286,347425832,136164286,257425832,97.4003746425,19.723256684,19.6388688514,27,0,0,
Sherlock Holmes,349,90000000,209028679,498438212,119028679,408438212,97.4003746425,20.0671994932,19.5868582188,30,0,0,
Ice Age: Dawn of the Dinosaurs,350,90000000,196573705,859701857,106573705,769701857,97.4003746425,20.5956052903,19.5472811068,50,0,0,
What Lies Beneath,351,90000000,155370362,288600000,65370362,198600000,97.4003746425,19.5490144171,19.4039258876,54,0,0,
Rio,352,90000000,143619809,487519809,53619809,397519809,97.4003746425,20.0459330491,19.3589721954,53,0,0,
The Departed,353,90000000,132384315,289660619,42384315,199660619,97.4003746425,19.5524404077,19.3140124673,92,0,0,
Charlie's Angels,354,90000000,125305545,259736090,35305545,169736090,97.4003746425,19.4509654113,19.2846117857,46,0,0,
Mulan,355,90000000,120618403,303498149,30618403,213498149,97.4003746425,19.5960947741,19.2646576275,2,0,0,
Tropic Thunder,356,90000000,110461307,191091250,20461307,101091250,97.4003746425,19.1699317169,19.2199999369,96,0,0,
The Girl with the Dragon Tattoo,357,90000000,102515793,239373970,12515793,149373970,97.4003746425,19.3755158527,19.1836203417,4,0,0,
Contact,358,90000000,100769177,165748848,10769177,75748848,97.4003746425,19.0423270356,19.1754426349,6,0,0,
You Don't Mess With the Zohan,359,90000000,100018837,202910991,10018837,112910991,97.4003746425,19.2243008978,19.1719088811,18,0,0,
Die Hard: With a Vengeance,360,90000000,99983259,366072426,9983259,276072426,97.4003746425,19.7727010737,19.1717410147,40,0,0,
Atlantis: The Lost Empire,361,90000000,84052762,186049020,-5947238,96049020,97.4003746425,19.1458073966,19.093595028,97,0,0,
Valkyrie,362,90000000,83077762,203902107,-6922238,113902107,97.4003746425,19.2287283606,19.0886079733,27,0,0,
Pixels,363,90000000,78747585,243566890,-11252415,153566890,97.4003746425,19.391524553,19.0661538938,86,0,0,
Artificial Intelligence: AI,364,90000000,78616689,235900000,-11383311,145900000,97.4003746425,19.3620552003,19.0654672207,32,0,0,
The Haunted Mansion,365,90000000,75817994,155750628,-14182006,65750628,97.4003746425,18.9871352091,19.0506714613,94,0,0,
Hollow Man,366,90000000,73209340,191200000,-16790660,101200000,97.4003746425,19.1704456684,19.0366804354,2,0,0,
The Interpreter,367,90000000,72515360,162561036,-17484640,72561036,97.4003746425,19.0250583374,19.0329252026,3,0,0,
Percy Jackson: Sea of Monsters,368,90000000,68559554,200859554,-21440446,110859554,97.4003746425,19.2150740698,19.0112461834,94,0,0,
Lara Croft: Tomb Raider: The Cradle of Life,369,90000000,65653758,157092943,-24346242,67092943,97.4003746425,18.9947244331,18.9950166799,96,0,0,
Spy Game,370,90000000,62362560,143049560,-27637440,53049560,97.4003746425,18.9123223374,18.9763107765,31,0,0,
The Saint,371,90000000,61355436,169392132,-28644564,79392132,97.4003746425,19.0617046753,18.9705160414,49,0,0,
Mission to Mars,372,90000000,60874615,106000000,-29125385,16000000,97.4003746425,18.655359445,18.9677376324,8,0,0,
Bicentennial Man,373,90000000,58220776,87420776,-31779224,-2579224,97.4003746425,18.4964467937,18.9522620525,79,0,0,
King Arthur,374,90000000,51877963,203877963,-38122037,113877963,97.4003746425,19.2286207384,18.9142744515,72,0,0,
Volcano,375,90000000,47474112,120027316,-42525888,30027316,97.4003746425,18.7605583045,18.887024139,28,0,0,
The Devil's Own,376,90000000,42877165,140891572,-47122835,50891572,97.4003746425,18.8990357408,18.8577639307,3,0,0,
K-19: The Widowmaker,377,90000000,35168966,65716126,-54831034,-24283874,97.4003746425,18.2717904972,18.8066931152,42,0,0,
The Three Musketeers,379,90000000,20374484,139874484,-69625516,49874484,97.4003746425,18.892711854,18.7007020854,61,0,0,
The Nutcracker in 3D,380,90000000,195459,20466016,-89804541,-69533984,97.4003746425,17.5270380484,18.5352299342,96,0,0,
Twister,381,88000000,241688385,495700000,153688385,407700000,96.8546928117,20.0657758007,19.6894005958,34,0,0,
Cinderella Man,382,88000000,61649911,105021488,-26350089,17021488,96.8546928117,18.6634051726,18.9836693063,56,0,0,
Fantastic Four,383,87500000,154695569,330716569,67195569,243216569,96.7168210134,19.683865816,19.4107306929,30,0,0,
Hannibal,384,87000000,165091986,350100000,78091986,263100000,96.5783570635,19.7385630703,19.4504191077,0,0,0,
Seabiscuit,385,86000000,120197488,148634976,34197488,62634976,96.2996287402,18.9692946208,19.2799303639,19,0,0,
Cast Away,386,85000000,233632142,427230516,148632142,342230516,96.0184589404,19.9306977066,19.6750808374,68,0,0,
Happy Feet,387,85000000,198000317,385000317,113000317,300000317,96.0184589404,19.8327660387,19.5678979035,5,0,0,
Ocean's Eleven,388,85000000,183417150,450728529,98417150,365728529,96.0184589404,19.981303911,19.5204872227,52,0,0,
The Bourne Supremacy,389,85000000,176087450,288587450,91087450,203587450,96.0184589404,19.5650235749,19.4957813567,56,0,0,
Air Force One,390,85000000,172620724,314932668,87620724,229932668,96.0184589404,19.6455817478,19.4838801498,11,0,0,
Fast & Furious,391,85000000,155064265,363064265,70064265,278064265,96.0184589404,19.7778410682,19.4213331609,45,0,0,
Horton Hears a Who,392,85000000,154529439,299477886,69529439,214477886,96.0184589404,19.5991145713,19.4193649936,43,0,0,
Divergent,393,85000000,150947895,276014965,65947895,191014965,96.0184589404,19.5241651678,19.4060840799,99,0,0,
Hotel Transylvania,394,85000000,148313048,345907363,63313048,260907363,96.0184589404,19.7326760512,19.3961998066,23,0,0,
Enchanted,395,85000000,127706877,340384141,42706877,255384141,96.0184589404,19.7176912835,19.3153318101,82,0,0,
Safe House,396,85000000,126181630,208542162,41181630,123542162,96.0184589404,19.2707992113,19.3090778446,49,0,0,
I Now Pronounce You Chuck and Larry,397,85000000,119725280,185708462,34725280,100708462,96.0184589404,19.1681205604,19.2821629619,44,0,0,
Ocean's Thirteen,398,85000000,117144465,311744465,32144465,226744465,96.0184589404,19.6361710871,19.271198213,50,0,0,
It's Complicated,399,85000000,112735375,224614744,27735375,139614744,96.0184589404,19.3372313861,19.2521832085,54,0,0,
Enemy of the State,400,85000000,111544445,250644445,26544445,165644445,96.0184589404,19.4362544337,19.2469844732,78,0,0,
Open Season,401,85000000,84325668,191152567,-674332,106152567,96.0184589404,19.1935758611,19.1201428881,35,0,0,
Tower Heist,402,85000000,78046570,153487972,-6953430,68487972,96.0184589404,19.0025511311,19.0884480172,3,0,0,
102 Dalmatians,403,85000000,66941559,66941559,-18058441,-18058441,96.0184589404,18.341548799,19.0298095912,16,0,0,
Mirror Mirror,404,85000000,64935167,173613482,-20064833,88613482,96.0184589404,19.1091355526,19.0188383774,53,0,0,
The Holiday,405,85000000,63224849,205135173,-21775151,120135173,96.0184589404,19.2561319158,19.0093901497,86,0,0,
The Fast and the Furious: Tokyo Drift,406,85000000,62514415,157693110,-22485585,72693110,96.0184589404,19.0257797485,19.0054391394,85,0,0,
Memoirs of a Geisha,407,85000000,57010853,161510853,-27989147,76510853,96.0184589404,19.0464111051,18.9742909574,97,0,0,
Enemy at the Gates,408,85000000,51396781,96971293,-33603219,11971293,96.0184589404,18.6229808522,18.9414850269,56,0,0,
Last Action Hero,409,85000000,50016394,137298489,-34983606,52298489,96.0184589404,18.9077180418,18.9332511348,81,0,0,
The Rundown,410,85000000,47641743,80831893,-37358257,-4168107,96.0184589404,18.4816077672,18.9189259491,64,0,0,
Arthur Christmas,411,85000000,46462469,149717124,-38537531,64717124,96.0184589404,18.9812524521,18.9117349348,73,0,0,
Cats & Dogs: The Revenge of Kitty Galore,412,85000000,45539292,114979922,-39460708,29979922,96.0184589404,18.7602208699,18.9060692481,77,0,0,
Meet Joe Black,413,85000000,44606335,44606335,-40393665,-40393665,96.0184589404,18.0648137166,18.9003107408,5,0,0,
Collateral Damage,414,85000000,40048332,78353508,-44951668,-6646492,96.0184589404,18.4580126553,18.8716904567,31,0,0,
Showtime,415,85000000,37948765,78948765,-47051235,-6051235,96.0184589404,18.463730722,18.8582263008,75,0,0,
Judge Dredd,416,85000000,34687912,113487912,-50312088,28487912,96.0184589404,18.7495394569,18.8369488425,1,0,0,
Zodiac,417,85000000,33080084,83080084,-51919916,-1919916,96.0184589404,18.5025401943,18.8262885419,48,0,0,
Scott Pilgrim vs. The World,418,85000000,31524275,47969723,-53475725,-37030277,96.0184589404,18.1117064595,18.8158638127,0,0,0,
The Core,419,85000000,31111260,74132631,-53888740,-10867369,96.0184589404,18.41650075,18.8130780457,68,0,0,
Father's Day,420,85000000,28659604,35659604,-56340396,-49340396,96.0184589404,17.928183557,18.7963800468,58,0,0,
Scooby-Doo,421,84000000,153294164,276294164,69294164,192294164,95.7347971738,19.528399463,19.4184979499,3,0,0,
Nutty Professor II: The Klumps,422,84000000,123307945,166307945,39307945,82307945,95.7347971738,19.0769470443,19.3013412557,48,0,0,
RED 2,423,84000000,53262560,137162560,-30737440,53162560,95.7347971738,18.913013231,18.9583656909,37,0,0,
Click,424,82500000,137340146,237669602,54840146,155169602,95.3045175335,19.3975766867,19.3637359582,3,0,0,
Charlotte's Web,425,82500000,82599768,143599768,99768,61099768,95.3045175335,18.9603853856,19.1239816456,52,0,0,
Jumper,426,82500000,81168265,223636949,-1331735,141136949,95.3045175335,19.3433001714,19.116871219,52,0,0,
Hellboy II: The Golden Army,427,82500000,75791785,160193345,-6708215,77693345,95.3045175335,19.05271599,19.089704818,31,0,0,
The Longest Yard,428,82000000,158119460,190320568,76119460,108320568,95.1597874007,19.2035352102,19.4433502845,21,0,0,
The Expendables,429,82000000,103068524,268268174,21068524,186268174,95.1597874007,19.5082941528,19.2227264765,12,0,0,
The 6th Day,430,82000000,34543701,96024898,-47456299,14024898,95.1597874007,18.6396165753,18.8556077047,86,0,0,
Bruce Almighty,431,81000000,242704995,483473962,161704995,402473962,94.8683298051,20.0556386418,19.7116922939,51,0,0,
The Hunger Games,432,80000000,408010692,677923379,328010692,597923379,94.5741609003,20.3784822258,20.0882970189,68,0,0,
The Hangover Part II,433,80000000,254464305,586464305,174464305,506464305,94.5741609003,20.2402410747,19.7461779125,17,0,0,
Mission: Impossible,434,80000000,180891004,457607112,100891004,377607112,94.5741609003,20.0059434856,19.5286898275,67,0,0,
Hotel Transylvania 2,435,80000000,167195684,437095684,87195684,357095684,94.5741609003,19.9630081393,19.4824111995,84,0,0,
Batman Returns,436,80000000,162833635,266824291,82833635,186824291,94.5741609003,19.5101666234,19.4672097983,69,0,0,
The Mummy,437,80000000,155247825,416247825,75247825,336247825,94.5741609003,19.917393459,19.4402106687,42,0,0,
Over the Hedge,438,80000000,155019340,336002981,75019340,256002981,94.5741609003,19.7193814395,19.4393860361,9,0,0,
Lilo & Stitch,439,80000000,145771527,245800000,65771527,165800000,94.5741609003,19.4368176869,19.4054255014,9,0,0,
Deep Impact,440,80000000,140300426,349300426,60300426,269300426,94.5741609003,19.7550254585,19.3847773348,17,0,0,
Grown Ups 2,441,80000000,133668525,247023808,53668525,167023808,94.5741609003,19.4412379733,19.3591628009,45,0,0,
Alvin and the Chipmunks: Chipwrecked,442,80000000,133107389,349088523,53107389,269088523,94.5741609003,19.7544672972,19.3569651045,69,0,0,
Get Smart,443,80000000,130319208,226739416,50319208,146739416,94.5741609003,19.3653243396,19.3459729567,5,0,0,
Robots,444,80000000,128200012,260700012,48200012,180700012,94.5741609003,19.4893500287,19.3375366481,40,0,0,
Shutter Island,445,80000000,128012934,299461782,48012934,219461782,94.5741609003,19.614336583,19.3367884791,60,0,0,
Something's Gotta Give,446,80000000,124685242,266685242,44685242,186685242,94.5741609003,19.5096987679,19.3233858599,33,0,0,
Four Christmases,447,80000000,120146040,168311558,40146040,88311558,94.5741609003,19.1076176809,19.3048092149,97,0,0,
Face/Off,448,80000000,112273211,241197065,32273211,161197065,94.5741609003,19.4200151175,19.2717480568,25,0,0,
Bedtime Stories,449,80000000,110101975,221468935,30101975,141468935,94.5741609003,19.3446188679,19.262434533,57,0,0,
The Road to Perdition,450,80000000,104054514,183354514,24054514,103354514,94.5741609003,19.1805738014,19.2360271279,40,0,0,
Just Go With It,451,80000000,103028109,214974953,23028109,134974953,94.5741609003,19.3185027541,19.2314750843,87,0,0,
Daredevil,452,80000000,102543518,182782518,22543518,102782518,94.5741609003,19.177894897,19.2293187306,30,0,0,
Eagle Eye,453,80000000,101440743,178066569,21440743,98066569,94.5741609003,19.1555302243,19.2243941549,83,0,0,
Con Air,454,80000000,101087161,224087161,21087161,144087161,94.5741609003,19.3549583498,19.2228100433,98,0,0,
Yogi Bear,455,80000000,100246011,204774690,20246011,124774690,94.5741609003,19.2760527718,19.2190314219,58,0,0,
Cold Mountain,456,80000000,95632614,165173909,15632614,85173909,94.5741609003,19.0917057794,19.1980492818,71,0,0,
The Book of Eli,457,80000000,94835059,158750817,14835059,78750817,94.5741609003,19.0583208119,19.1943768733,15,0,0,
Flubber,458,80000000,92969824,177969824,12969824,97969824,94.5741609003,19.1550661492,19.1857352216,76,0,0,
The Haunting,459,80000000,91188905,180188905,11188905,100188905,94.5741609003,19.1656570236,19.1774139266,18,0,0,
Space Jam,460,80000000,90443603,250180069,10443603,170180069,94.5741609003,19.4525487419,19.1739108656,30,0,0,
Fury,461,80000000,85755593,211755593,5755593,131755593,94.5741609003,19.3052984805,19.1515904308,83,0,0,
The Pink Panther,462,80000000,82226474,158926474,2226474,78926474,94.5741609003,19.0592487956,19.1344527383,48,0,0,
Zookeeper,463,80000000,80360866,170805525,360866,90805525,94.5741609003,19.1200871298,19.1252731128,83,0,0,
Conspiracy Theory,465,80000000,76081498,142746226,-3918502,62746226,94.5741609003,18.9699371613,19.1038928295,71,0,0,
"Six Days, Seven Nights",466,80000000,74292149,164752855,-5707851,84752855,94.5741609003,19.0895510976,19.0948156818,88,0,0,
Spirit: Stallion of the Cimarron,467,80000000,73215310,106515310,-6784690,26515310,94.5741609003,18.735240007,19.0893130301,5,0,0,
Swordfish,468,80000000,69772969,147080413,-10227031,67080413,94.5741609003,18.9946538562,19.0715167488,5,0,0,
Lost In Space,469,80000000,69102910,136032598,-10897090,56032598,94.5741609003,18.9304027991,19.0680155352,13,0,0,
The Manchurian Candidate,470,80000000,65948711,96148711,-14051289,16148711,94.5741609003,18.6565347976,19.0513674135,74,0,0,
Déjà Vu,471,80000000,64038616,181038616,-15961384,101038616,94.5741609003,19.1696828743,19.0411493603,69,0,0,
Bewitched,472,80000000,62252415,130098562,-17747585,50098562,94.5741609003,18.8941085291,19.0314986747,90,0,0,
Fantasia 2000 (IMAX),473,80000000,60507228,60507228,-19492772,-19492772,94.5741609003,18.3259025927,19.021978768,36,0,0,
The Time Machine,474,80000000,56684819,98983590,-23315181,18983590,94.5741609003,18.6786803588,19.0008055763,8,0,0,
What Dreams May Come,475,80000000,55350897,71350897,-24649103,-8649103,94.5741609003,18.4385318507,18.9933098784,22,0,0,
Mighty Joe Young,476,80000000,50628009,50628009,-29371991,-29371991,94.5741609003,18.2109253082,18.9663096268,8,0,0,
The Legend of Zorro,477,80000000,45356386,141256386,-34643614,61256386,94.5741609003,18.9612979274,18.93528546,1,0,0,
Little Nicky,478,80000000,39442871,58270391,-40557129,-21729609,94.5741609003,18.3010030359,18.8992983661,5,0,0,
Surrogates,479,80000000,38577772,119668350,-41422228,39668350,94.5741609003,18.8269361531,18.893923453,16,0,0,
Evolution,480,80000000,38311134,98341932,-41688866,18341932,94.5741609003,18.673710609,18.8922609735,15,0,0,
The Brothers Grimm,481,80000000,37899638,105299638,-42100362,25299638,94.5741609003,18.7263246329,18.8896898727,64,0,0,
Mars Attacks!,482,80000000,37754208,101354208,-42245792,21354208,94.5741609003,18.6968299428,18.8887796166,20,0,0,
The Wild,483,80000000,37384046,99384046,-42615954,19384046,94.5741609003,18.6817694877,18.8864590027,44,0,0,
Walking with Dinosaurs,484,80000000,36076121,130580730,-43923879,50580730,94.5741609003,18.8971072772,18.8782159774,60,0,0,
Thirteen Days,485,80000000,34566746,66554547,-45433254,-13445453,94.5741609003,18.3902709065,18.868618113,70,0,0,
Daylight,486,80000000,32885565,158885565,-47114435,78885565,94.5741609003,19.0590327531,18.8578181863,65,0,0,
The Last Witch Hunter,487,80000000,26997690,98945125,-53002310,18945125,94.5741609003,18.6783831358,18.819047458,72,0,0,
Pompeii,488,80000000,23169033,108469033,-56830967,28469033,94.5741609003,18.7494035671,18.7930050731,58,0,0,
Battlefield Earth: A Saga of the Year 3000,489,80000000,21471685,29725663,-58528315,-50274337,94.5741609003,17.9127825812,18.7812391794,15,0,0,
Looney Tunes: Back in Action,490,80000000,20950820,54540662,-59049180,-25459338,94.5741609003,18.2580547971,18.777600645,23,0,0,
Nine,491,80000000,19676965,53508858,-60323035,-26491142,94.5741609003,18.2458403336,18.7686458694,54,0,0,
Timeline,492,80000000,19480739,26703184,-60519261,-53296816,94.5741609003,17.8612498941,18.7672593106,28,0,0,
Oceans,493,80000000,19422319,86787530,-60577681,6787530,94.5741609003,18.57971467,18.7668461356,37,0,0,
Babe: Pig in the City,494,80000000,18318000,69130000,-61682000,-10870000,94.5741609003,18.4164743295,18.7590035601,67,0,0,
The Postman,495,80000000,17593391,20783810,-62406609,-59216190,94.5741609003,17.7519149473,18.7538239599,33,0,0,
Red Planet,496,80000000,17480890,33463969,-62519110,-46536031,94.5741609003,17.9730522891,18.7530173765,10,0,0,
Arthur et les Minimoys,497,80000000,15132763,113325743,-64867237,33325743,94.5741609003,18.7837669866,18.7360320968,38,0,0,
The Invasion,498,80000000,15074191,40147042,-64925809,-39852958,94.5741609003,18.0725022316,18.7356047037,39,0,0,
Fantasia 2000 (Theatrical Release),499,80000000,9103630,9103630,-70896370,-70896370,94.5741609003,17.493174149,18.6910509598,87,0,0,
A Sound of Thunder,500,80000000,1900451,6300451,-78099549,-73699549,94.5741609003,17.4196676409,18.6345152766,97,0,0,
The Lion King,502,79300000,422780140,987480140,343480140,908180140,94.3665976093,20.7417247992,20.1170693767,95,0,0,
Journey 2: The Mysterious Island,503,79000000,103860290,318146162,24860290,239146162,94.2772210946,19.6722899157,19.239586233,14,0,0,
Jack and Jill,504,79000000,74158157,150519217,-4841843,71519217,94.2772210946,19.0193494233,19.0992191238,41,0,0,
A Beautiful Mind,505,78000000,170708996,317668058,92708996,239668058,93.9774487115,19.6737816554,19.5012998451,50,0,0,
Cloudy with a Chance of Meatballs 2,506,78000000,119793567,274392649,41793567,196392649,93.9774487115,19.5418464189,19.311591668,7,0,0,
Red Dragon,507,78000000,92955420,206455420,14955420,128455420,93.9774487115,19.2915793124,19.1949319504,8,0,0,
Hidalgo,508,78000000,67286731,107336658,-10713269,29336658,93.9774487115,18.7556296782,19.0689772634,90,0,0,
The League of Extraordinary Gentlemen,509,78000000,66465204,179265204,-11534796,101265204,93.9774487115,19.1707536952,19.0646719497,99,0,0,
Exorcist: The Beginning,510,78000000,41814863,43957541,-36185137,-34042459,93.9774487115,18.1515951208,18.9260284956,25,0,0,
Despicable Me 2,513,76000000,368065385,974873764,292065385,898873764,93.3691484757,20.7325466427,20.01805965,95,0,0,
2 Fast 2 Furious,514,76000000,127120058,236410607,51120058,160410607,93.3691484757,19.4171157747,19.3491426221,16,0,0,
Children of Men,515,76000000,35327768,69628780,-40672232,-6371220,93.3691484757,18.4606609956,18.8985848881,96,0,0,
The Adventures of Rocky & Bullwinkle,516,76000000,26000610,35129610,-49999390,-40870390,93.3691484757,18.0579856008,18.839008973,56,0,0,
Independence Day,517,75000000,306124059,817355682,231124059,742355682,93.0604859102,20.5640425579,19.8863992677,85,0,0,
The Lost World: Jurassic Park,518,75000000,229074524,618626844,154074524,543626844,93.0604859102,20.298735771,19.6904857963,19,0,0,
Ice Age: The Meltdown,519,75000000,195330621,651899282,120330621,576899282,93.0604859102,20.3483534894,19.5909062875,21,0,0,
Madagascar,520,75000000,193166575,556130620,118166575,481130620,93.0604859102,20.1983089387,19.584168672,6,0,0,
Grown Ups,521,75000000,162001186,272223430,87001186,197223430,93.0604859102,19.5445502728,19.4817382886,69,0,0,
Shark Tale,522,75000000,161412000,371917043,86412000,296917043,93.0604859102,19.8252257566,19.4796970952,74,0,0,
X-Men,523,75000000,157299717,296339717,82299717,221339717,93.0604859102,19.6200126731,19.4653331615,81,0,0,
Wanted,524,75000000,134327125,342235034,59327125,267235034,93.0604859102,19.7495718036,19.3810589655,52,0,0,
The Rock,525,75000000,133955936,335955936,58955936,260955936,93.0604859102,19.7328068411,19.3796372365,4,0,0,
50 First Dates,526,75000000,120776832,196324496,45776832,121324496,93.0604859102,19.2612765011,19.327802178,77,0,0,
Hairspray,527,75000000,118871849,202871849,43871849,127871849,93.0604859102,19.2891336403,19.3200823338,35,0,0,
Now You See Me,528,75000000,117723989,351723989,42723989,276723989,93.0604859102,19.774385359,19.315401753,17,0,0,
Dreamgirls,529,75000000,103365956,154965956,28365956,79965956,93.0604859102,19.0647227503,19.2549249623,57,0,0,
Inspector Gadget,530,75000000,97360069,97360069,22360069,22360069,93.0604859102,18.7044324351,19.2285011966,88,0,0,
Immortals,531,75000000,83504017,211562435,8504017,136562435,93.0604859102,19.3249502172,19.1647365005,64,0,0,
The Terminal,532,75000000,77073959,218673959,2073959,143673959,93.0604859102,19.3533336858,19.133705451,5,0,0,
Constantine,533,75000000,75500759,221119492,500759,146119492,93.0604859102,19.3629110531,19.125964379,64,0,0,
Monster House,534,75000000,73661010,141267370,-1338990,66267370,93.0604859102,18.9900636041,19.1168350536,44,0,0,
Hotel for Dogs,535,75000000,73034460,118230763,-1965540,43230763,93.0604859102,18.850389616,19.1137068222,31,0,0,
Vertical Limit,536,75000000,68473360,213500000,-6526640,138500000,93.0604859102,19.3327636032,19.0906344279,16,0,0,
Charlie Wilson's War,537,75000000,66661095,119512771,-8338905,44512771,93.0604859102,18.8586970207,19.0813172121,94,0,0,
Life,538,75000000,64016268,73475268,-10983732,-1524732,93.0604859102,18.5061748122,19.0675619143,2,0,0,
Be Cool,539,75000000,55849401,94944017,-19150599,19944017,93.0604859102,18.6860731805,19.0238524608,61,0,0,
Munich,540,75000000,47379090,131492772,-27620910,56492772,93.0604859102,18.9331630787,18.9764056064,1,0,0,
Killers,541,75000000,47059963,95572749,-27940037,20572749,93.0604859102,18.6908833697,18.9745732365,42,0,0,
The Man From U.N.C.L.E.,542,75000000,45445109,105445109,-29554891,30445109,93.0604859102,18.7635279814,18.9652492009,12,0,0,
Tears of the Sun,543,75000000,43632458,85632458,-31367542,10632458,93.0604859102,18.6119843413,18.9546784826,24,0,0,
Lady in the Water,544,75000000,42285169,72785169,-32714831,-2214831,93.0604859102,18.4998191445,18.9467485532,93,0,0,
Spanglish,545,75000000,42044321,54344321,-32955679,-20655679,93.0604859102,18.3130349859,18.9453243108,82,0,0,
Bandits,546,75000000,41523271,71523271,-33476729,-3476729,93.0604859102,18.4880918198,18.9422361492,4,0,0,
Anna and the King,547,75000000,39251128,39251128,-35748872,-35748872,93.0604859102,18.1290089901,18.9286570062,32,0,0,
First Knight,548,75000000,37027335,127027335,-37972665,52027335,93.0604859102,18.9060505626,18.9151858456,76,0,0,
Sucker Punch,549,75000000,36392502,89758389,-38607498,14758389,93.0604859102,18.645491952,18.9113066584,16,0,0,
Hostage,550,75000000,34636443,77636443,-40363557,2636443,93.0604859102,18.5436652066,18.9004970956,71,0,0,
Hollywood Homicide,551,75000000,30207785,51107785,-44792215,-23892215,93.0604859102,18.2763255795,18.8727056324,56,0,0,
Titan A.E.,552,75000000,22751979,36751979,-52248021,-38248021,93.0604859102,18.0949813653,18.8240990923,100,0,0,
Flight of the Phoenix,553,75000000,21009180,34009180,-53990820,-40990820,93.0604859102,18.0562532841,18.8123883232,61,0,0,
Soldier,554,75000000,14567883,14567883,-60432117,-60432117,93.0604859102,17.7278959979,18.7678753189,52,0,0,
Virus,555,75000000,14010690,30626690,-60989310,-44373310,93.0604859102,18.0063302577,18.763930043,53,0,0,
Monkeybone,556,75000000,5409517,5409517,-69590483,-69590483,93.0604859102,17.5256562494,18.7009668184,61,0,0,
Minions,557,74000000,335861250,1162157655,261861250,1088157655,92.7487211073,20.9044266345,19.9549695261,69,0,0,
The SpongeBob Movie: Sponge Out of Water,558,74000000,162994032,311594032,88994032,237594032,92.7487211073,19.6678402538,19.4886116459,7,0,0,
Unbreakable,559,73243106,94999143,248099143,21756037,174856037,92.5106405937,19.4690738244,19.225804616,22,0,0,
Talladega Nights: The Ballad of Ricky Bobby,560,73000000,148213377,162870525,75213377,89870525,92.4337803258,19.1154304748,19.4400863848,67,0,0,
Snake Eyes,561,73000000,55585389,103885389,-17414611,30885389,92.4337803258,18.7666479815,19.0333047807,94,0,0,
Sphere,562,73000000,36976367,50076367,-36023633,-22923633,92.4337803258,18.2874534081,18.927002368,85,0,0,
The Simpsons Movie,563,72500000,183135014,527071022,110635014,454571022,92.2750951393,20.1523739238,19.5603592693,8,0,0,
Fool's Gold,564,72500000,70231041,109362966,-2268959,36862966,92.2750951393,18.8080715448,19.1121883913,3,0,0,
Funny People,565,72500000,51855045,71880305,-20644955,-619695,92.2750951393,18.5144492543,19.0156436315,74,0,0,
The Kingdom,566,72500000,47467250,86509602,-25032750,14009602,92.2750951393,18.6394936838,18.9911436091,58,0,0,
Doctor Dolittle 2,567,72000000,112950721,176101721,40950721,104101721,92.1155870319,19.1840625188,19.308127631,58,0,0,
Braveheart,568,72000000,75545647,209045647,3545647,137045647,92.1155870319,19.3269045298,19.1408931739,72,0,0,
Jarhead,569,72000000,62647540,96947540,-9352460,24947540,92.1155870319,18.7237275373,19.0760682208,97,0,0,
Driven,570,72000000,32616869,54616869,-39383131,-17383131,92.1155870319,18.3488314146,18.906546588,23,0,0,
The Majestic,571,72000000,27796042,37306334,-44203958,-34693666,92.1155870319,18.1430358106,18.8764419485,67,0,0,
Two Brothers,572,72000000,18947630,61947630,-53052370,-10052370,92.1155870319,18.4246515699,18.8187112908,50,0,0,
The Village,573,71682975,114197520,257641634,42514545,185958659,92.0140200622,19.5072504813,19.3145453435,30,0,0,
Doctor Dolittle,574,71500000,144156464,294156464,72656464,222656464,91.9552459767,19.6239734351,19.430817985,12,0,0,
Signs,575,70702619,227965690,408265690,157263071,337563071,91.6977913628,19.9203335065,19.6994021215,100,0,0,
Shrek 2,576,70000000,436471036,932252921,366471036,862252921,91.4691219229,20.6955895196,20.1583576939,83,0,0,
Cars,577,70000000,244082982,461651246,174082982,391651246,91.4691219229,20.0343128246,19.7451643349,59,0,0,
Alvin and the Chipmunks: The Squeakquel,578,70000000,219614612,443483213,149614612,373483213,91.4691219229,19.9974579656,19.6778793832,25,0,0,
Runaway Bride,579,70000000,152149590,310030259,82149590,240030259,91.4691219229,19.674815631,19.4648048541,17,0,0,
Who Framed Roger Rabbit?,580,70000000,151931137,349318645,81931137,279318645,91.4691219229,19.781064524,19.4640356037,21,0,0,
xXx,581,70000000,141715000,266985000,71715000,196985000,91.4691219229,19.5437750279,19.4273835742,54,0,0,
Ransom,582,70000000,136448821,308656140,66448821,238656140,91.4691219229,19.6708872532,19.4079522337,27,0,0,
Inglourious Basterds,583,70000000,120774594,316915264,50774594,246915264,91.4691219229,19.6942696423,19.3477765502,64,0,0,
Die Hard 2,584,70000000,117323878,239814025,47323878,169814025,91.4691219229,19.4512435268,19.3340279439,87,0,0,
S.W.A.T.,585,70000000,116877597,207154748,46877597,137154748,91.4691219229,19.3273452521,19.332235953,80,0,0,
Hook,586,70000000,109921554,291121554,39921554,221121554,91.4691219229,19.6193549234,19.3038814913,59,0,0,
Sleepy Hollow,587,70000000,101068340,207068340,31068340,137068340,91.4691219229,19.326996216,19.2665904742,44,0,0,
Vanilla Sky,588,70000000,100614858,202726605,30614858,132726605,91.4691219229,19.3092995021,19.264642384,6,0,0,
Hercules,589,70000000,99046791,250634690,29046791,180634690,91.4691219229,19.4891256451,19.257876804,61,0,0,
Olympus Has Fallen,590,70000000,98927592,150562164,28927592,80562164,91.4691219229,19.0678489368,19.2573606313,17,0,0,
Battle: Los Angeles,591,70000000,83552429,213463976,13552429,143463976,91.4691219229,19.3525070436,19.1884424648,93,0,0,
AVP: Alien Vs. Predator,592,70000000,80281096,172543519,10281096,102543519,91.4691219229,19.1767734322,19.1731454195,10,0,0,
War Horse,593,70000000,79883359,156815529,9883359,86815529,91.4691219229,19.1000624689,19.1712695094,2,0,0,
We Were Soldiers,594,70000000,78120196,114658262,8120196,44658262,91.4691219229,18.8596354559,19.1629109839,41,0,0,
The Monuments Men,595,70000000,78031620,158702748,8031620,88702748,91.4691219229,19.1095838813,19.162489228,40,0,0,
Star Trek: Insurrection,596,70000000,70177571,117789913,177571,47789913,91.4691219229,18.8796244054,19.1243666565,21,0,0,
Big Fish,597,70000000,66432867,123954323,-3567133,53954323,91.4691219229,18.9178408079,19.1056656436,59,0,0,
Underworld: Awakening,598,70000000,62321039,160379930,-7678961,90379930,91.4691219229,19.1179701935,19.0847201746,26,0,0,
Wolf,599,70000000,59486001,125486001,-10513999,55486001,91.4691219229,18.9271141943,19.070018775,1,0,0,
Dracula Untold,600,70000000,55991880,216821942,-14008120,146821942,91.4691219229,19.3656451642,19.0515971439,32,0,0,
Wall Street 2: Money Never Sleeps,601,70000000,52474616,137431619,-17525384,67431619,91.4691219229,18.9966301857,19.0327042917,30,0,0,
The Abyss,602,70000000,49710458,49710458,-20289542,-20289542,91.4691219229,18.3171041918,19.0176021102,56,0,0,
The Dilemma,603,70000000,48475290,70546865,-21524710,546865,91.4691219229,18.525014696,19.0107792401,54,0,0,
The Siege,604,70000000,40932372,116623995,-29067628,46623995,91.4691219229,18.8722290988,18.9680717876,27,0,0,
Rock of Ages,605,70000000,38518613,50118613,-31481387,-19881387,91.4691219229,18.3216209482,18.9540108359,17,0,0,
Stardust,606,70000000,38373235,136760542,-31626765,66760542,91.4691219229,18.9928504521,18.9531576147,36,0,0,
Seven Years in Tibet,607,70000000,37901509,131401509,-32098491,61401509,91.4691219229,18.9621427504,18.950384038,5,0,0,
Sky Captain and the World of Tomorrow,608,70000000,37760080,49730854,-32239920,-20269146,91.4691219229,18.3173303845,18.949550986,86,0,0,
I Spy,609,70000000,33561137,60279822,-36438863,-9720178,91.4691219229,18.4279548634,18.9244966047,73,0,0,
Bad Company,610,70000000,30157016,69157016,-39842984,-842984,91.4691219229,18.512414153,18.9037137276,79,0,0,
Doom,611,70000000,28031250,54431250,-41968750,-15568750,91.4691219229,18.3681392183,18.8905129273,57,0,0,
Escape Plan,612,70000000,25135965,103735965,-44864035,33735965,91.4691219229,18.7866161264,18.8722485098,55,0,0,
Killer Elite,613,70000000,25124986,65409046,-44875014,-4590954,91.4691219229,18.4776212986,18.8721786118,33,0,0,
Hard Rain,614,70000000,19819494,19819494,-50180506,-50180506,91.4691219229,17.9143406453,18.837816254,70,0,0,
Hart's War,615,70000000,19076815,33076815,-50923185,-36923185,91.4691219229,18.113164019,18.8329104936,59,0,0,
Rollerball,616,70000000,18990542,25852508,-51009458,-44147492,91.4691219229,18.0097419326,18.8323390546,14,0,0,
The Legend of Hercules,617,70000000,18848538,61402445,-51151462,-8597555,91.4691219229,18.4390380823,18.8313977633,54,0,0,
Ballistic: Ecks vs. Sever,618,70000000,14294842,14294842,-55705158,-55705158,91.4691219229,17.8181981329,18.8007334277,38,0,0,
Osmosis Jones,619,70000000,13596911,13596911,-56403089,-56403089,91.4691219229,17.8053674274,18.795949373,7,0,0,
Legends of Oz: Dorothys Return,620,70000000,8462347,20107933,-61537653,-49892067,91.4691219229,17.9191150314,18.7600321746,81,0,0,
Blackhat,621,70000000,7889395,19472469,-62110605,-50527531,91.4691219229,17.90856614,18.7559430776,94,0,0,
Basic Instinct 2,622,70000000,5946136,35417162,-64053864,-34582838,91.4691219229,18.1444976904,18.7419483815,24,0,0,
Agora,623,70000000,619423,38992292,-69380577,-31007708,91.4691219229,18.1905444756,18.7025515437,45,0,0,
Despicable Me,624,69000000,251513985,543495033,182513985,474495033,91.1406817119,20.1870288538,19.7673381009,73,0,0,
Dinner for Schmucks,625,69000000,73026337,86796502,4026337,17796502,91.1406817119,18.6694666539,19.1432297145,42,0,0,
The Twilight Saga: Eclipse,626,68000000,300531751,706102828,232531751,638102828,90.8086518523,20.4336526611,19.8896445261,85,0,0,
The Sum of All Fears,627,68000000,118471320,193500000,50471320,125500000,90.8086518523,19.2791315018,19.3465757706,89,0,0,
The Score,628,68000000,71069884,113542091,3069884,45542091,90.8086518523,18.8653174166,19.1385751942,24,0,0,
Hall Pass,629,68000000,45060734,87173475,-22939266,19173475,90.8086518523,18.6801463268,19.0029078442,95,0,0,
Money Train,630,68000000,35305090,77205090,-32694910,9205090,90.8086518523,18.6001259347,18.9468662643,83,0,0,
Dreamcatcher,631,68000000,33685268,75685268,-34314732,7685268,90.8086518523,18.5873429134,18.9372493791,88,0,0,
Mystery Men,632,68000000,29762011,33462011,-38237989,-34537989,90.8086518523,18.1450886656,18.9135663965,94,0,0,
The Insider,633,68000000,28965197,60265197,-39034803,-7734803,90.8086518523,18.4474729948,18.9086870851,97,0,0,
Doctor Seuss' The Lorax,634,67500000,214030500,350976753,146530500,283476753,90.6412619207,19.7916761582,19.669067927,19,0,0,
Body of Lies,635,67500000,39394666,108394666,-28105334,40894666,90.6412619207,18.8350719491,18.9736228093,100,0,0,
Abraham Lincoln: Vampire Hunter,636,67500000,37519139,109471676,-29980861,41971676,90.6412619207,18.8421630098,18.9627751247,96,0,0,
Last Man Standing,637,67000000,18100017,18100017,-48899983,-48899983,90.4729394453,17.9353646187,18.8462186259,95,0,0,
The Last Legion,638,67000000,5932060,25332060,-61067940,-41667940,90.4729394453,18.0464570316,18.7633720379,66,0,0,
Entrapment,639,66000000,87707396,211700000,21707396,145700000,90.1334477574,19.3612747131,19.2255871512,16,0,0,
The X Files: Fight the Future,640,66000000,83826398,189104508,17826398,123104508,90.1334477574,19.268927083,19.2080817239,87,0,0,
Need for Speed,641,66000000,43568507,194169619,-22431493,128169619,90.1334477574,19.2903823039,19.0057405165,50,0,0,
Saving Private Ryan,642,65000000,216119491,484819491,151119491,419819491,89.7900760012,20.0888963653,19.682150872,41,0,0,
What Women Want,643,65000000,182805123,374105123,117805123,309105123,89.7900760012,19.8547060537,19.5830388772,70,0,0,
Lincoln,644,65000000,182207973,273346281,117207973,208346281,89.7900760012,19.5800635983,19.5811695576,75,0,0,
Ice Age,645,65000000,176387405,386116343,111387405,321116343,89.7900760012,19.8829323672,19.5627634402,40,0,0,
Apollo 13,646,65000000,172036360,334065864,107036360,269065864,89.7900760012,19.754407594,19.5487796025,100,0,0,
The Matrix,647,65000000,171383253,463420706,106383253,398420706,89.7900760012,20.0477050021,19.5466635978,79,0,0,
Les Miserables,648,65000000,148809770,442169052,83809770,377169052,89.7900760012,20.0050455241,19.4706316787,46,0,0,
The Santa Clause 2,649,65000000,139225854,172825854,74225854,107825854,89.7900760012,19.2012713149,19.4365169469,23,0,0,
You've Got Mail,650,65000000,115731542,250710047,50731542,185710047,89.7900760012,19.5064113826,19.3476061784,43,0,0,
Unbroken,651,65000000,115637895,163278355,50637895,98278355,89.7900760012,19.1565453871,19.3472354843,95,0,0,
Spy!,652,65000000,110825712,233125712,45825712,168125712,89.7900760012,19.4452013055,19.3279994796,42,0,0,
Total Recall,653,65000000,108580729,250585890,43580729,185585890,89.7900760012,19.5059920724,19.3188973179,57,0,0,
Due Date,654,65000000,100539043,211739043,35539043,146739043,89.7900760012,19.3653228893,19.2855955002,26,0,0,
Step Brothers,655,65000000,100468793,128468793,35468793,63468793,89.7900760012,18.9741004329,19.2852996425,55,0,0,
Jumanji,656,65000000,100109938,262409938,35109938,197409938,89.7900760012,19.5451562769,19.2837869585,24,0,0,
The Mask of Zorro,657,65000000,93771072,233642327,28771072,168642327,89.7900760012,19.4470540733,19.2566824409,98,0,0,
Space Cowboys,658,65000000,90454043,128874043,25454043,63874043,89.7900760012,18.9764278296,19.2422007521,80,0,0,
Annie,659,65000000,85911262,139840525,20911262,74840525,89.7900760012,19.0374368628,19.2220210481,42,0,0,
Cliffhanger,660,65000000,84049211,255000000,19049211,190000000,89.7900760012,19.5207927142,19.213630417,69,0,0,
Broken Arrow,661,65000000,70640985,148340985,5640985,83340985,89.7900760012,19.0822919881,19.1510384745,46,0,0,
World Trade Center,662,65000000,70278893,163295654,5278893,98295654,89.7900760012,19.1566282617,19.1492926216,26,0,0,
The Kid,663,65000000,69688384,69688384,4688384,4688384,89.7900760012,18.5616474039,19.1464388846,52,0,0,
Mona Lisa Smile,664,65000000,63803100,141205169,-1196900,76205169,89.7900760012,19.044774753,19.1175431197,2,0,0,
The Dictator,665,65000000,59650222,180148897,-5349778,115148897,89.7900760012,19.2342702611,19.0966387485,42,0,0,
Eyes Wide Shut,666,65000000,55637680,104213915,-9362320,39213915,89.7900760012,18.8239043886,19.0760170224,89,0,0,
This Means War,667,65000000,54760791,156974557,-10239209,91974557,89.7900760012,19.1258790126,19.0714532252,72,0,0,
Focus,668,65000000,53862963,154362963,-11137037,89362963,89.7900760012,19.1128935131,19.0667587696,53,0,0,
Blade: Trinity,669,65000000,52397389,132397389,-12602611,67397389,89.7900760012,18.9964377361,19.0590480856,5,0,0,
Red Dawn,670,65000000,44806783,48164150,-20193217,-16835850,89.7900760012,18.3546946904,19.0181322425,19,0,0,
We Are Marshall,671,65000000,43545364,43545364,-21454636,-21454636,89.7900760012,18.3040975558,19.0111675658,74,0,0,
Resident Evil: Retribution,672,65000000,42345531,238940997,-22654469,173940997,89.7900760012,19.4658614503,19.0044976063,57,0,0,
Primary Colors,673,65000000,38966057,38966057,-26033943,-26033943,89.7900760012,18.2512710572,18.9854681532,23,0,0,
Fight Club,674,65000000,37030102,100853753,-27969898,35853753,89.7900760012,18.8011971726,18.9744016081,38,0,0,
Death Race,675,65000000,36097530,72298317,-28902470,7298317,89.7900760012,18.5840620531,18.9690266996,3,0,0,
The Long Kiss Goodnight,676,65000000,33430951,33430951,-31569049,-31569049,89.7900760012,18.1834533925,18.9534964362,6,0,0,
Proof of Life,677,65000000,32598931,62761005,-32401069,-2238995,89.7900760012,18.4995958655,18.9486009316,52,0,0,
Zathura,678,65000000,28045540,58545540,-36954460,-6454460,89.7900760012,18.4598608987,18.9213763985,44,0,0,
The Missing,679,65000000,26900336,38253433,-38099664,-26746567,89.7900760012,18.2427934414,18.9144110134,92,0,0,
Elektra,680,65000000,24409722,56409722,-40590278,-8590278,89.7900760012,18.4391095261,18.8990929407,42,0,0,
Astro Boy,681,65000000,19551067,41636243,-45448933,-23363757,89.7900760012,18.2824122634,18.8685179278,39,0,0,
"I, Frankenstein",682,65000000,19075290,74575290,-45924710,9575290,89.7900760012,18.6032150449,18.8654730404,66,0,0,
Hudson Hawk,683,65000000,16355667,16355667,-48644333,-48644333,89.7900760012,17.9395095329,18.847887696,1,0,0,
Sin City: A Dame to Kill For,684,65000000,13757804,39499349,-51242196,-25500651,89.7900760012,18.2575685916,18.8307958574,11,0,0,
Lucky Numbers,685,65000000,10014234,10014234,-54985766,-54985766,89.7900760012,17.8312533019,18.8056407522,77,0,0,
Oliver Twist,686,65000000,1987287,26587287,-63012713,-38412713,89.7900760012,18.0926977774,18.7494707477,59,0,0,
Tian jiang xiong shi,687,65000000,74070,116864070,-64925930,51864070,89.7900760012,18.905045211,18.7356038206,66,0,0,
Little Man,689,64000000,58295702,101295702,-5704298,37295702,89.4427191,18.8110047622,19.0948337877,64,0,0,
Random Hearts,690,64000000,31054924,63200000,-32945076,-800000,89.4427191,18.5128062399,18.9453870538,60,0,0,
Perfume: The Story of a Murderer,691,63700000,2223293,133603463,-61476707,69903463,89.3377186618,19.0104305085,18.7604661574,57,0,0,
Jurassic Park,692,63000000,395708305,1038812584,332708305,975812584,89.0912674351,20.8060090421,20.0971221857,35,0,0,
Austin Powers in Goldmember,693,63000000,213117789,292738626,150117789,229738626,89.0912674351,19.6450115155,19.6793096456,7,0,0,
Hop,694,63000000,108085305,188657593,45085305,125657593,89.0912674351,19.2797991866,19.3250066864,1,0,0,
Wyatt Earp,695,63000000,25052000,25052000,-37948000,-37948000,89.0912674351,18.0991280436,18.9153362594,98,0,0,
Clear and Present Danger,696,62000000,121832939,207320283,59832939,145320283,88.7356065738,19.3597912138,19.3829930873,86,0,0,
U-571,697,62000000,77086030,127630030,15086030,65630030,88.7356065738,18.98645054,19.1955339451,100,0,0,
The American President,698,62000000,60009496,107809496,-1990504,45809496,88.7356065738,18.8670301679,19.1135819793,4,0,0,
The Love Guru,699,62000000,32200122,40123346,-29799878,-21876654,88.7356065738,18.2993442674,18.9638270399,91,0,0,
3000 Miles to Graceland,700,62000000,15738632,18708848,-46261368,-43291152,88.7356065738,18.0225748405,18.8633128746,5,0,0,
Gone Girl,701,61000000,167767189,368567189,106767189,307567189,88.3756169761,19.8510336906,19.5479080563,17,0,0,
Blades of Glory,702,61000000,118245842,145245842,57245842,84245842,88.3756169761,19.0869503572,19.3730609958,50,0,0,
Maze Runner: The Scorch Trials,703,61000000,81213941,310213941,20213941,249213941,88.3756169761,19.7006813291,19.2188870738,8,0,0,
2 Guns,704,61000000,75612460,132493015,14612460,71493015,88.3756169761,19.0192054218,19.1933494857,35,0,0,
Meet the Fockers,705,60000000,279167575,516567575,219167575,456567575,88.0111736793,20.1559012845,19.8584020186,95,0,0,
The Lego Movie,706,60000000,257784718,457729388,197784718,397729388,88.0111736793,20.0463455454,19.8062899679,32,0,0,
300,707,60000000,210592590,454139586,150592590,394139586,88.0111736793,20.0392564354,19.680657377,18,0,0,
Wild Hogs,708,60000000,168213584,253555383,108213584,193555383,88.0111736793,19.5325567625,19.5525824242,81,0,0,
Marley & Me,709,60000000,143153751,247812011,83153751,187812011,88.0111736793,19.5134837011,19.4683332686,44,0,0,
The Green Mile,710,60000000,136801374,290701374,76801374,230701374,88.0111736793,19.6478375582,19.4457996742,55,0,0,
Chicken Little,711,60000000,135386665,310043823,75386665,250043823,88.0111736793,19.7029860513,19.4407114287,49,0,0,
The Truman Show,712,60000000,125466701,263966701,65466701,203966701,88.0111736793,19.566230507,19.4042862222,90,0,0,
The Bourne Identity,713,60000000,121468960,214357371,61468960,154357371,88.0111736793,19.3945141317,19.3892233784,100,0,0,
Couples Retreat,714,60000000,109205660,172450423,49205660,112450423,88.0111736793,19.2222367818,19.3415489074,95,0,0,
The Italian Job,715,60000000,106126012,176262839,46126012,116262839,88.0111736793,19.2391958157,19.3292107714,79,0,0,
Goldeneye,716,60000000,105978900,355978900,45978900,295978900,88.0111736793,19.8229201594,19.3286175629,55,0,0,
Daddy Day Care,717,60000000,104148781,164285587,44148781,104285587,88.0111736793,19.1849191283,19.3212082952,82,0,0,
The General's Daughter,718,60000000,102705852,149705852,42705852,89705852,88.0111736793,19.1146080902,19.3153276204,89,0,0,
The Prince of Egypt,719,60000000,101217900,218417900,41217900,158417900,88.0111736793,19.409731639,19.3092270172,51,0,0,
Collateral,720,60000000,100170152,217670152,40170152,157670152,88.0111736793,19.406946669,19.3049088103,17,0,0,
Cats & Dogs,721,60000000,93375151,200700000,33375151,140700000,88.0111736793,19.3415618918,19.2764418555,81,0,0,
Two Weeks Notice,722,60000000,93354918,199043309,33354918,139043309,88.0111736793,19.3349436252,19.2763558698,54,0,0,
Antz,723,60000000,90646554,152346554,30646554,92346554,88.0111736793,19.1277150308,19.2647786686,47,0,0,
The Scorpion King,724,60000000,90580000,165890634,30580000,105890634,88.0111736793,19.1923658514,19.2644924821,72,0,0,
Red,725,60000000,90380162,196439693,30380162,136439693,88.0111736793,19.324453188,19.2636326731,91,0,0,
Starsky & Hutch,726,60000000,88200225,170200225,28200225,110200225,88.0111736793,19.2120904102,19.254205095,24,0,0,
Cheaper by the Dozen 2,727,60000000,82571173,135015330,22571173,75015330,88.0111736793,19.0383798272,19.2294419162,25,0,0,
Eat Pray Love,728,60000000,80574010,206598789,20574010,146598789,88.0111736793,19.3647774068,19.2205065606,90,0,0,
Jack Reacher,729,60000000,80070736,217370736,20070736,157370736,88.0111736793,19.4058293228,19.2182422492,44,0,0,
Days of Thunder,730,60000000,78771268,153771268,18771268,93771268,88.0111736793,19.1347157961,19.2123719109,18,0,0,
Man on Fire,731,60000000,77906816,130968579,17906816,70968579,88.0111736793,19.0163188445,19.2084475796,74,0,0,
The Family Man,732,60000000,75764085,124715863,15764085,64715863,88.0111736793,18.9812452532,19.1986533583,63,0,0,
Contagion,733,60000000,75658097,137551594,15658097,77551594,88.0111736793,19.0519622868,19.1981663984,54,0,0,
Any Given Sunday,734,60000000,75530832,100230832,15530832,40230832,88.0111736793,18.8306760685,19.1975813682,65,0,0,
The Horse Whisperer,735,60000000,75370763,186870763,15370763,126870763,88.0111736793,19.2849242342,19.1968450535,10,0,0,
Coraline,736,60000000,75286229,126037057,15286229,66037057,88.0111736793,18.9887594715,19.1964559796,46,0,0,
Ladder 49,737,60000000,74541707,102332848,14541707,42332848,88.0111736793,18.8445297611,19.1930227098,86,0,0,
Deep Blue Sea,738,60000000,73648228,165048228,13648228,105048228,88.0111736793,19.1884643678,19.1888869218,65,0,0,
Michael Jackson's This Is It,739,60000000,72091016,252091016,12091016,192091016,88.0111736793,19.5277282163,19.1816376691,78,0,0,
Kangaroo Jack,740,60000000,66723216,90723216,6723216,30723216,88.0111736793,18.7654998909,19.1562384343,32,0,0,
The Happening,741,60000000,64506874,162778384,4506874,102778384,88.0111736793,19.1778755096,19.1455600673,59,0,0,
Rules of Engagement,742,60000000,61322858,71719931,1322858,11719931,88.0111736793,18.6209254915,19.1300170654,89,0,0,
The Shaggy Dog,743,60000000,61123569,87123569,1123569,27123569,88.0111736793,18.7396711384,19.1290361411,70,0,0,
Jingle All the Way,744,60000000,60573641,129813641,573641,69813641,88.0111736793,19.009932352,19.1263243283,72,0,0,
Hellboy,745,60000000,59103901,99303901,-896099,39303901,88.0111736793,18.8245054608,19.1190404258,0,0,0,
A Civil Action,746,60000000,56702901,56702901,-3297099,-3297099,88.0111736793,18.4897696123,19.1070259535,8,0,0,
ParaNorman,747,60000000,56003051,107593122,-3996949,47593122,88.0111736793,18.8783800091,19.1034965997,75,0,0,
The Jackal,748,60000000,54910560,159310560,-5089440,99310560,88.0111736793,19.1614784014,19.0979621309,92,0,0,
Paycheck,749,60000000,53789313,98819789,-6210687,38819789,88.0111736793,18.8212675124,19.0922499557,34,0,0,
Up Close & Personal,750,60000000,50984674,100584674,-9015326,40584674,88.0111736793,18.8330215999,19.0778172278,68,0,0,
The Tale of Despereaux,751,60000000,50877145,90482317,-9122855,30482317,88.0111736793,18.763792029,19.0772597136,21,0,0,
The Boxtrolls,752,60000000,50837305,109285033,-9162695,49285033,88.0111736793,18.8890284718,19.0770530731,90,0,0,
The Tuxedo,753,60000000,50586000,104429625,-9414000,44429625,88.0111736793,18.8581603228,19.0757486289,13,0,0,
Jack Ryan: Shadow Recruit,754,60000000,50577412,131377412,-9422588,71377412,88.0111736793,19.0185698404,19.0757040213,32,0,0,
Under Siege 2: Dark Territory,755,60000000,50002097,104302097,-9997903,44302097,88.0111736793,18.8573365842,19.0727111887,51,0,0,
Miss Congeniality 2: Armed and Fabulous,756,60000000,48478006,101382396,-11521994,41382396,88.0111736793,18.8382894065,19.0647391826,32,0,0,
Alien: Resurrection,757,60000000,47748610,160653592,-12251390,100653592,88.0111736793,19.1678606747,19.060901355,67,0,0,
Shooter,758,60000000,47003582,95703582,-12996418,35703582,88.0111736793,18.8001702141,19.0569660121,78,0,0,
Practical Magic,759,60000000,46611204,68097643,-13388796,8097643,88.0111736793,18.5908275298,19.0548871733,99,0,0,
Gangster Squad,760,60000000,46000903,104100903,-13999097,44100903,88.0111736793,18.8560356352,19.0516451545,5,0,0,
Year One,761,60000000,43337279,57604723,-16662721,-2395277,88.0111736793,18.4981505909,19.0373711962,54,0,0,
Edge of Darkness,762,60000000,43313890,82812456,-16686110,22812456,88.0111736793,18.7078329111,19.0372449514,64,0,0,
Star Trek: Nemesis,763,60000000,43119879,67178296,-16880121,7178296,88.0111736793,18.5830422341,19.0361971392,41,0,0,
Reign of Fire,764,60000000,43061982,82150183,-16938018,22150183,88.0111736793,18.7028508409,19.035884237,83,0,0,
Planet 51,765,60000000,42194060,108996113,-17805940,48996113,88.0111736793,18.8872180914,19.0311818114,40,0,0,
Duplicity,766,60000000,40572825,81079566,-19427175,21079566,88.0111736793,18.6947440608,19.0223382404,0,0,0,
Righteous Kill,767,60000000,40081410,78481410,-19918590,18481410,88.0111736793,18.6747929925,19.0196421329,51,0,0,
Invictus,768,60000000,37491364,124514011,-22508636,64514011,88.0111736793,18.9800922425,19.0053106817,83,0,0,
State of Play,769,60000000,37017955,88832210,-22982045,28832210,88.0111736793,18.7520144582,19.0026688296,17,0,0,
My Favorite Martian,770,60000000,36850101,36850101,-23149899,-23149899,88.0111736793,18.2848649499,19.0017304442,67,0,0,
The Sentinel,771,60000000,36280697,78080697,-23719303,18080697,88.0111736793,18.6716802038,18.9985406232,58,0,0,
Trouble with the Curve,772,60000000,35763137,47818913,-24236863,-12181087,88.0111736793,18.4032207516,18.9956323801,57,0,0,
Intolerable Cruelty,773,60000000,35327628,121327628,-24672372,61327628,88.0111736793,18.9617127467,18.9931786232,51,0,0,
The Relic,774,60000000,33927476,33927476,-26072524,-26072524,88.0111736793,18.2508139201,18.9852488035,15,0,0,
Mercury Rising,775,60000000,32940507,32940507,-27059493,-27059493,88.0111736793,18.239047938,18.9796210353,82,0,0,
Almost Famous,776,60000000,32522352,47371191,-27477648,-12628809,88.0111736793,18.3986542624,18.9772271003,4,0,0,
Analyze That,777,60000000,32122249,54994757,-27877751,-5005243,88.0111736793,18.4737000385,18.9749311353,2,0,0,
The Soloist,778,60000000,31720158,38389024,-28279842,-21610976,88.0111736793,18.302339295,18.9726184393,3,0,0,
The Mortal Instruments: City of Bones,779,60000000,31165421,75965567,-28834579,15965567,88.0111736793,18.6550871031,18.969418968,78,0,0,
The Legend of Bagger Vance,780,60000000,30695227,39235486,-29304773,-20764514,88.0111736793,18.3118222063,18.966699064,40,0,0,
Dragonfly,781,60000000,30063805,30063805,-29936195,-29936195,88.0111736793,18.2039422242,18.9630348367,36,0,0,
Priest,782,60000000,29136626,84154026,-30863374,24154026,88.0111736793,18.7178496835,18.9576298411,51,0,0,
Garfield's A Tail of Two Kitties,783,60000000,28426747,147985373,-31573253,87985373,88.0111736793,19.1059752478,18.9534717605,94,0,0,
Event Horizon,784,60000000,26668092,26668092,-33331908,-33331908,88.0111736793,18.1608516055,18.9430954324,22,0,0,
Sinbad: Legend of the Seven Seas,785,60000000,26483452,80767884,-33516548,20767884,88.0111736793,18.6923715805,18.9419997571,98,0,0,
XXX: State of the Union,786,60000000,26082914,70282914,-33917086,10282914,88.0111736793,18.609093346,18.939618783,17,0,0,
Dark Water,787,60000000,25473093,49473093,-34526907,-10526907,88.0111736793,18.4199138,18.9359828175,52,0,0,
The Avengers,788,60000000,23385416,48585416,-36614584,-11414584,88.0111736793,18.4109905252,18.9234342981,76,0,0,
The Black Dahlia,789,60000000,22545080,49110792,-37454920,-10889208,88.0111736793,18.4162814212,18.9183384561,34,0,0,
EDtv,790,60000000,22421087,35232087,-37578913,-24767913,88.0111736793,18.2661571664,18.9175843527,94,0,0,
The Spirit,791,60000000,19806188,39006188,-40193812,-20993812,88.0111736793,18.3092622492,18.901547091,20,0,0,
The Last Castle,792,60000000,18208078,20541668,-41791922,-39458332,88.0111736793,18.078076485,18.8916176813,56,0,0,
Inkheart,793,60000000,17303424,58051454,-42696576,-1948546,88.0111736793,18.5022763623,18.8859528535,18,0,0,
Supernova,794,60000000,14218868,14218868,-45781132,-45781132,88.0111736793,17.9847942113,18.866392891,6,0,0,
Flyboys,795,60000000,13090630,14816379,-46909370,-45183621,88.0111736793,17.9939912999,18.8591417892,76,0,0,
Winter's Tale,796,60000000,12600231,22468620,-47399769,-37531380,88.0111736793,18.1048579016,18.8559735632,18,0,0,
Holy Man,797,60000000,12065985,12065985,-47934015,-47934015,88.0111736793,17.9509367132,18.8525106009,84,0,0,
Meet Dave,798,60000000,11803254,50648806,-48196746,-9351194,88.0111736793,18.4316112676,18.8508031795,52,0,0,
The Great Raid,799,60000000,10166502,10597070,-49833498,-49402930,88.0111736793,17.9271597282,18.8401001892,67,0,0,
In the Name of the King: A Dungeon Siege Tale,800,60000000,4775656,13075656,-55224344,-46924344,88.0111736793,17.9669582234,18.8040159625,59,0,0,
Beyond Borders,801,60000000,4426297,11427090,-55573703,-48572910,88.0111736793,17.9406644672,18.8016319466,22,0,0,
American Sniper,802,58000000,350126372,547326372,292126372,489326372,87.2683969479,20.2120678339,20.0181830961,6,0,0,
Goosebumps,803,58000000,77772085,112992948,19772085,54992948,87.2683969479,18.9241384311,19.2168961419,22,0,0,
Rambo III,804,58000000,53715611,188715611,-4284389,130715611,87.2683969479,19.3009954415,19.1020434192,63,0,0,
Sabrina,805,58000000,53458319,87100000,-4541681,29100000,87.2683969479,18.7539352522,19.1007408613,60,0,0,
Red Tails,806,58000000,49876377,50365498,-8123623,-7634502,87.2683969479,18.4484490122,19.0824285743,97,0,0,
Just Like Heaven,807,58000000,48318130,100687083,-9681870,42687083,87.2683969479,18.8468456259,19.0743563251,39,0,0,
The Internship,808,58000000,44672764,93672764,-13327236,35672764,87.2683969479,18.7999593319,19.0552136073,10,0,0,
The Flintstones in Viva Rock Vegas,809,58000000,35231365,59431365,-22768635,1431365,87.2683969479,18.5329517899,19.0038606251,5,0,0,
Leatherheads,810,58000000,31230175,41204865,-26769825,-16795135,87.2683969479,18.3551295183,18.9812760292,84,0,0,
Did You Hear About the Morgans?,811,58000000,29580087,80480566,-28419913,22480566,87.2683969479,18.7053393103,18.9718115388,35,0,0,
"Che, El Ar the Argentine",812,58000000,293708,30118557,-57706292,-27881443,87.2683969479,18.2291424312,18.7869546729,37,0,0,
Sex and the City,813,57500000,152647258,415247258,95147258,357747258,87.0797074183,19.9644007734,19.5095408981,35,0,0,
Resident Evil: Afterlife,814,57500000,60128566,295874190,2628566,238374190,87.0797074183,19.6700792934,19.1364202208,52,0,0,
That's My Boy,815,57500000,36931089,58058367,-20568911,558367,87.0797074183,18.5251183149,19.0160629893,75,0,0,
Devil's Advocate,816,57000000,60984028,152984028,3984028,95984028,86.8897832617,19.1454926147,19.1430242776,98,0,0,
Ghost Rider: Spirit of Vengeance,817,57000000,51774002,149217355,-5225998,92217355,86.8897832617,19.1270777418,19.0972681807,96,0,0,
Dragonheart,818,57000000,51317350,104317350,-5682650,47317350,86.8897832617,18.8766335715,19.0949440971,95,0,0,
After the Sunset,819,57000000,28328132,38329114,-28671868,-18670886,86.8897832617,18.3348979502,18.9703584726,80,0,0,
Captain Corelli's Mandolin,820,57000000,25528495,62097495,-31471505,5097495,86.8897832617,18.56519431,18.9540688068,35,0,0,
Anger Management,821,56000000,135560942,195660942,79560942,139660942,86.5061545414,19.337416113,19.4556510446,1,0,0,
The Pacifier,822,56000000,113006880,198006880,57006880,142006880,86.5061545414,19.3467519784,19.3721386036,29,0,0,
Walking Tall,823,56000000,46213824,47313824,-9786176,-8686176,86.5061545414,18.4381676136,19.0738136506,84,0,0,
Forrest Gump,824,55000000,330151138,679857164,275151138,624857164,86.1173529963,20.4157992092,19.9832208645,13,0,0,
Alvin and the Chipmunks,825,55000000,217326974,362605033,162326974,307605033,86.1173529963,19.8511242186,19.7134012283,65,0,0,
Hitch,826,55000000,177784257,366784257,122784257,311784257,86.1173529963,19.8610714025,19.5984910083,42,0,0,
Meet the Parents,827,55000000,166225040,304599899,111225040,249599899,86.1173529963,19.7017538603,19.5622451121,26,0,0,
The Pursuit of Happyness,828,55000000,162586036,307325633,107586036,252325633,86.1173529963,19.7092957773,19.5505570372,53,0,0,
Pocahontas,829,55000000,141567679,347087906,86567679,292087906,86.1173529963,19.813300428,19.4802368393,89,0,0,
Superman,830,55000000,134218018,300200000,79218018,245200000,86.1173529963,19.6894583396,19.4544321093,4,0,0,
The Nutty Professor,831,55000000,128769345,273769345,73769345,218769345,86.1173529963,19.6122355238,19.4348625623,63,0,0,
Captain Phillips,832,55000000,107136417,220648184,52136417,165648184,86.1173529963,19.4362679761,19.3531508333,27,0,0,
George Of The Jungle,833,55000000,105224566,174424566,50224566,119424566,86.1173529963,19.2530454057,19.3455977107,86,0,0,
American Wedding,834,55000000,104354205,126425115,49354205,71425115,86.1173529963,19.0188321588,19.342140199,26,0,0,
The Equalizer,835,55000000,101530738,192165283,46530738,137165283,86.1173529963,19.3273877988,19.3308409586,91,0,0,
Casper,836,55000000,100237375,282209181,45237375,227209181,86.1173529963,19.6375483212,19.3256220986,50,0,0,
Date Night,837,55000000,98711404,152269033,43711404,97269033,86.1173529963,19.1516980867,19.3194294096,80,0,0,
Maid in Manhattan,838,55000000,93932896,163838217,38932896,108838217,86.1173529963,19.2058985855,19.2997854341,17,0,0,
Crimson Tide,839,55000000,91381194,159381194,36381194,104381194,86.1173529963,19.18536426,19.2891354194,27,0,0,
Flightplan,840,55000000,89706988,214392904,34706988,159392904,86.1173529963,19.4133514074,19.2820856688,13,0,0,
City of Angels,841,55000000,78745923,198745923,23745923,143745923,86.1173529963,19.3536168301,19.2346607227,66,0,0,
Paddington,842,55000000,76223578,259541430,21223578,204541430,86.1173529963,19.5680567584,19.2234215136,46,0,0,
R.V.,843,55000000,71452035,87252035,16452035,32252035,86.1173529963,18.7762710389,19.2018083802,8,0,0,
Stargate,844,55000000,71346004,196346004,16346004,141346004,86.1173529963,19.3441307708,19.2013227576,42,0,0,
Kill Bill: Volume 1,845,55000000,70098138,176469428,15098138,121469428,86.1173529963,19.2619016197,19.1955897337,32,0,0,
Mr. Poppers's Penguins,846,55000000,68224452,189624452,13224452,134624452,86.1173529963,19.3170735956,19.1869193263,96,0,0,
Bowfinger,847,55000000,66365290,98606290,11365290,43606290,86.1173529963,18.852830184,19.1782411769,1,0,0,
Kill Bill: Volume 2,848,55000000,66207920,153535982,11207920,98535982,86.1173529963,19.1577788939,19.1775031403,81,0,0,
Tango & Cash,849,55000000,61772769,61772769,6772769,6772769,86.1173529963,18.5795887555,19.156475883,72,0,0,
Death Becomes Her,850,55000000,58422650,149022650,3422650,94022650,86.1173529963,19.1359459673,19.1402944312,77,0,0,
Shanghai Noon,851,55000000,56932305,71189835,1932305,16189835,86.1173529963,18.6568595816,19.1330108795,95,0,0,
Executive Decision,852,55000000,56472312,121872312,1472312,66872312,86.1173529963,18.9934809711,19.1307520649,48,0,0,
Free Birds,853,55000000,55750480,110387072,750480,55387072,86.1173529963,18.9265178297,19.1271971617,43,0,0,
Alien 3,854,55000000,52360659,155933485,-2639341,100933485,86.1173529963,19.1691856512,19.11033172,78,0,0,
The Forbidden Kingdom,855,55000000,52075270,129075270,-2924730,74075270,86.1173529963,19.0332982884,19.1088987511,32,0,0,
The Phantom of the Opera,856,55000000,51225796,158225796,-3774204,103225796,86.1173529963,19.1799715849,19.104621258,58,0,0,
Muppets Most Wanted,857,55000000,51178893,79312301,-3821107,24312301,86.1173529963,18.719024847,19.1043845459,7,0,0,
Evita,858,55000000,49994804,151894804,-5005196,96894804,86.1173529963,19.1498948524,19.0983899956,3,0,0,
Ronin,859,55000000,41609593,70690810,-13390407,15690810,86.1173529963,18.6529112992,19.0548786292,30,0,0,
Burlesque,860,55000000,39440655,89657398,-15559345,34657398,86.1173529963,18.7929863699,19.0433087603,75,0,0,
The Ghost and the Darkness,861,55000000,38553833,38553833,-16446167,-16446167,86.1173529963,18.3588486905,19.0385393157,26,0,0,
Changeling,862,55000000,35739802,113805580,-19260198,58805580,86.1173529963,18.946921868,19.0232526937,24,0,0,
The Watch,863,55000000,34353000,67353000,-20647000,12353000,86.1173529963,18.6260939741,19.0156323515,68,0,0,
The Hunted,864,55000000,34234008,45016494,-20765992,-9983506,86.1173529963,18.4253372457,19.0149757889,76,0,0,
Instinct,865,55000000,34105207,34105207,-20894793,-20894793,86.1173529963,18.3103685334,19.014264617,81,0,0,
Stuck On You,866,55000000,33832741,63537164,-21167259,8537164,86.1173529963,18.5945282136,19.0127585333,47,0,0,
Semi-Pro,867,55000000,33479698,43980363,-21520302,-11019637,86.1173529963,18.4149705217,19.0108036722,34,0,0,
The Pirates! Band of Misfits,868,55000000,31051126,124080105,-23948874,69080105,86.1173529963,19.0058548157,18.9972516748,63,0,0,
Aeon Flux,869,55000000,25857987,47953341,-29142013,-7046659,86.1173529963,18.4541501714,18.9676414098,80,0,0,
Chain Reaction,870,55000000,20550712,59533842,-34449288,4533842,86.1173529963,18.5603042768,18.936446344,73,0,0,
The Fan,871,55000000,18406215,18406215,-36593785,-36593785,86.1173529963,18.1176339972,18.9235600956,87,0,0,
Elizabeth: The Golden Age,872,55000000,16285240,74870866,-38714760,19870866,86.1173529963,18.6855120244,18.9106497385,39,0,0,
Imagine That,873,55000000,16123323,16123323,-38876677,-38876677,86.1173529963,18.08623636,18.9096572692,88,0,0,
Gods and Generals,874,55000000,12882934,12923936,-42117066,-42076064,86.1173529963,18.0405057968,18.8895853633,29,0,0,
Turbulence,875,55000000,11466088,11466088,-43533912,-43533912,86.1173529963,18.0189535911,18.8806808103,1,0,0,
Bullet to the Head,876,55000000,9489829,22597969,-45510171,-32402031,86.1173529963,18.1728372836,18.8681265351,10,0,0,
All the King's Men,877,55000000,7221458,9521458,-47778542,-45478542,86.1173529963,17.9894623486,18.8535196087,27,0,0,
Thunderbirds,878,55000000,6768055,28231444,-48231945,-26768556,86.1173529963,18.2425307064,18.8505742087,75,0,0,
A Very Long Engagement,879,55000000,6167817,69759296,-48832183,14759296,86.1173529963,18.6454991959,18.8466615454,82,0,0,
Lucky You,880,55000000,5755286,6521829,-49244714,-48478171,86.1173529963,17.9421943739,18.84396355,33,0,0,
Eye See You,882,55000000,79161,1807990,-54920839,-53192010,86.1173529963,17.8630819806,18.8060824684,86,0,0,
Superman II,883,54000000,101347629,101347629,47347629,47347629,85.723212891,18.8768254746,19.3341232234,20,0,0,
Blade 2,884,54000000,81676888,154338601,27676888,100338601,85.723212891,19.1663674463,19.2519285268,9,0,0,
"You, Me and Dupree",885,54000000,75628110,130228110,21628110,76228110,85.723212891,19.0448976511,19.2252325771,73,0,0,
Seven Pounds,886,54000000,69951824,166617328,15951824,112617328,85.723212891,19.2229852881,19.1995153401,80,0,0,
The Godfather: Part III,887,54000000,66520529,66520529,12520529,12520529,85.723212891,18.627457251,19.1836424251,53,0,0,
Elizabethtown,888,54000000,26850426,50719373,-27149574,-3280627,85.723212891,18.4899233244,18.9791058062,51,0,0,
Gigli,889,54000000,6068735,7107195,-47931265,-46892805,85.723212891,17.9674545749,18.852528457,7,0,0,
Shaft,890,53012938,70327868,107190108,17314930,54177170,85.3287666649,18.9191953695,19.2057516997,18,0,0,
The Dukes of Hazzard,891,53000000,80270227,109848461,27270227,56848461,85.3235599895,18.9352914134,19.2501559255,88,0,0,
Law Abiding Citizen,892,53000000,73357727,131159781,20357727,78159781,85.3235599895,19.055192071,19.2195340965,95,0,0,
Black Mass,893,53000000,62573133,90073133,9573133,37073133,85.3235599895,18.8094971958,19.1698038946,63,0,0,
Anastasia,894,53000000,58297830,139695831,5297830,86695831,85.3235599895,19.0994554993,19.1493840033,70,0,0,
Moulin Rouge,895,53000000,57386369,179213196,4386369,126213196,85.3235599895,19.282149597,19.1449761911,10,0,0,
Domestic Disturbance,896,53000000,45207112,54207112,-7792888,1207112,85.3235599895,18.5309454007,19.0841335431,27,0,0,
Flags of Our Fathers,897,53000000,33602376,63657941,-19397624,10657941,85.3235599895,18.6121947786,19.022500138,12,0,0,
Grindhouse,898,53000000,25031037,50187789,-27968963,-2812211,85.3235599895,18.4942845913,18.9744069825,62,0,0,
Beloved,899,53000000,22843047,22843047,-30156953,-30156953,85.3235599895,18.2011966015,18.9617505739,30,0,0,
Zero Dark Thirty,900,52500000,95720716,134612435,43220716,82112435,85.1216093192,19.0759322536,19.3174299254,30,0,0,
Catch Me if You Can,901,52000000,164606800,355612291,112606800,303612291,84.9182109499,19.8415275663,19.5666476304,67,0,0,
Mamma Mia!,902,52000000,143762955,602133452,91762955,550133452,84.9182109499,20.308634387,19.4980839552,98,0,0,
The Break-Up,903,52000000,118703275,205727307,66703275,153727307,84.9182109499,19.3921319692,19.4088998596,95,0,0,
Valentine's Day,904,52000000,110485654,217569328,58485654,165569328,84.9182109499,19.435982327,19.3778330536,18,0,0,
Casino,905,52000000,42388160,110349860,-9611840,58349860,84.9182109499,18.9442257445,19.0747205062,87,0,0,
The Change-Up,906,52000000,37081475,75835124,-14918525,23835124,84.9182109499,18.7154776906,19.0467410712,96,0,0,
The Thin Red Line,907,52000000,36385763,97694306,-15614237,45694306,84.9182109499,18.866292726,19.0430142035,24,0,0,
Man on the Moon,908,52000000,34580635,47407635,-17419365,-4592365,84.9182109499,18.4776079695,19.0332790171,56,0,0,
From Paris With Love,909,52000000,24077427,53139168,-27922573,1139168,84.9182109499,18.530336711,18.9746735986,97,0,0,
Bulletproof Monk,910,52000000,23010607,23010607,-28989393,-28989393,84.9182109499,18.2156330825,18.9685242411,35,0,0,
"Me, Myself & Irene",911,51000000,90570999,149270999,39570999,98270999,84.5069726623,19.1565101446,19.3024310443,97,0,0,
Barnyard: The Original Party Animals,912,51000000,72779000,118583844,21779000,67583844,84.5069726623,18.9974855844,19.2259072628,39,0,0,
Deck the Halls,913,51000000,35093569,46815807,-15906431,-4184193,84.5069726623,18.4814564039,19.0414447948,64,0,0,
The Adjustment Bureau,914,50200000,62495645,126931325,12295645,76731325,84.1736053259,19.0475896503,19.1825932782,35,0,0,
The Twilight Saga: New Moon,915,50000000,296623634,687557727,246623634,637557727,84.0896415254,20.4329241896,19.9215640562,70,0,0,
Shrek,916,50000000,267655011,491812794,217655011,441812794,84.0896415254,20.1295350053,19.8548036928,4,0,0,
Ted,917,50000000,218665740,556016627,168665740,506016627,84.0896415254,20.2395151387,19.7306529245,58,0,0,
22 Jump Street,918,50000000,191719337,331333876,141719337,281333876,84.0896415254,19.7862215267,19.6551652692,40,0,0,
Robin Hood: Prince of Thieves,919,50000000,165360108,390366200,115360108,340366200,84.0896415254,19.9265708124,19.5753627602,12,0,0,
Jerry Maguire,920,50000000,153620822,273668230,103620822,223668230,84.0896415254,19.6270061947,19.53766373,53,0,0,
As Good as it Gets,921,50000000,147637474,313271386,97637474,263271386,84.0896415254,19.7390217681,19.5178880294,31,0,0,
Patch Adams,922,50000000,135014968,202173000,85014968,152173000,84.0896415254,19.3862310232,19.474840459,47,0,0,
Into the Woods,923,50000000,128002372,203502372,78002372,153502372,84.0896415254,19.3912801526,19.4500990445,99,0,0,
Anchorman 2: The Legend Continues,924,50000000,127352707,172185754,77352707,122185754,84.0896415254,19.2649855411,19.4477756487,20,0,0,
Super 8,925,50000000,127004179,257972745,77004179,207972745,84.0896415254,19.5788912047,19.4465269802,67,0,0,
Mr. Deeds,926,50000000,126203320,171179403,76203320,121179403,84.0896415254,19.2606502964,19.4436518278,50,0,0,
Erin Brockovich,927,50000000,125548685,257805243,75548685,207805243,84.0896415254,19.5783650302,19.4412954761,60,0,0,
How to Lose a Guy in 10 Days,928,50000000,105807520,178890782,55807520,128890782,84.0896415254,19.2933999716,19.3674961843,35,0,0,
Interview with the Vampire: The Vampire Chronicles,929,50000000,105163524,223463524,55163524,173463524,84.0896415254,19.4641811092,19.3649945169,7,0,0,
Yes Man,930,50000000,97690976,225990976,47690976,175990976,84.0896415254,19.4730439003,19.3354995812,59,0,0,
Non-Stop,931,50000000,91742160,212742160,41742160,162742160,84.0896415254,19.4256868742,19.3113807322,22,0,0,
Stepmom,932,50000000,91030827,159638444,41030827,109638444,84.0896415254,19.2095411413,19.3084573775,88,0,0,
Disney Planes,933,50000000,90282580,219782580,40282580,169782580,84.0896415254,19.4511313228,19.3053730672,26,0,0,
Failure to Launch,934,50000000,88715192,128402901,38715192,78402901,84.0896415254,19.0564802499,19.2988812176,86,0,0,
Inside Man,935,50000000,88513495,185677523,38513495,135677523,84.0896415254,19.321361329,19.2980427546,98,0,0,
"Crazy, Stupid, Love",936,50000000,84351197,147142328,34351197,97142328,84.0896415254,19.1510879187,19.2805810786,67,0,0,
Payback,937,50000000,81526121,161626121,31526121,111626121,84.0896415254,19.2185318582,19.2685531907,20,0,0,
Congo,938,50000000,80998938,151998938,30998938,101998938,84.0896415254,19.1742133648,19.2662925796,76,0,0,
Knowing,939,50000000,79957634,186450317,29957634,136450317,84.0896415254,19.3244962184,19.261812296,20,0,0,
The Ring Two,940,50000000,75941727,161941727,25941727,111941727,84.0896415254,19.2199520091,19.244343108,35,0,0,
We Bought a Zoo,941,50000000,75624550,118729073,25624550,68729073,84.0896415254,19.0038976222,19.2429502973,69,0,0,
Moneyball,942,50000000,75605492,111300835,25605492,61300835,84.0896415254,18.9615567598,19.2428665467,24,0,0,
Garfield,943,50000000,75367693,208094550,25367693,158094550,84.0896415254,19.4085282811,19.2418209449,25,0,0,
Christmas with the Kranks,944,50000000,73701902,96469187,23701902,46469187,84.0896415254,18.8712430406,19.2344656506,14,0,0,
V for Vendetta,945,50000000,70511035,130214162,20511035,80214162,84.0896415254,19.0660253935,19.2202235063,12,0,0,
Outbreak,946,50000000,67598303,67598303,17598303,17598303,84.0896415254,18.6679200079,19.2070432936,96,0,0,
Race to Witch Mountain,947,50000000,67172594,105103783,17172594,55103783,84.0896415254,18.9248081346,19.2051023124,6,0,0,
The Forgotten,948,50000000,66711892,117211892,16711892,67211892,84.0896415254,18.995394181,19.2029975305,53,0,0,
Herbie: Fully Loaded,949,50000000,66010682,144110682,16010682,94110682,84.0896415254,19.136376406,19.1997854268,37,0,0,
Shanghai Knights,950,50000000,60470220,88316835,10470220,38316835,84.0896415254,18.8178923992,19.1740361821,77,0,0,
Planes: Fire and Rescue,951,50000000,59157732,96657732,9157732,46657732,84.0896415254,18.8724438595,19.1678380268,51,0,0,
Curious George,952,50000000,58336565,70749050,8336565,20749050,84.0896415254,18.6922280382,19.1639404807,23,0,0,
American Reunion,953,50000000,56758835,236799211,6758835,186799211,84.0896415254,19.5100822534,19.1564091196,32,0,0,
Hansel & Gretel: Witch Hunters,954,50000000,55703475,214949716,5703475,164949716,84.0896415254,19.4337349918,19.1513394664,35,0,0,
I am Number Four,955,50000000,55100437,146195159,5100437,96195159,84.0896415254,19.1465148437,19.1484310604,79,0,0,
Don't Say a Word,956,50000000,54997476,104488383,4997476,54488383,84.0896415254,18.921083993,19.1479336409,82,0,0,
Unfaithful,957,50000000,52752475,119114494,2752475,69114494,84.0896415254,19.0060463472,19.1370257425,74,0,0,
Syriana,958,50000000,50824620,92690959,824620,42690959,84.0896415254,18.8468709362,19.1275628718,82,0,0,
Resident Evil: Apocalypse,959,50000000,50740078,125168734,740078,75168734,84.0896415254,19.0392066145,19.1271458411,1,0,0,
The Book of Life,960,50000000,50151543,97651543,151543,47651543,84.0896415254,18.8787495925,19.1242378725,82,0,0,
Absolute Power,961,50000000,50007168,50007168,7168,7168,84.0896415254,18.5201405749,19.1235232179,78,0,0,
Firewall,962,50000000,48751189,82751189,-1248811,32751189,84.0896415254,18.7797628055,19.1172844937,16,0,0,
The Game,963,50000000,48265581,80369970,-1734419,30369970,84.0896415254,18.7629945426,19.1148618998,13,0,0,
G.I. Jane,964,50000000,48154732,48154732,-1845268,-1845268,84.0896415254,18.5032277656,19.1143080743,82,0,0,
Into the Storm,965,50000000,47602194,156602194,-2397806,106602194,84.0896415254,19.1956495229,19.1115428909,80,0,0,
The Judge,966,50000000,47119388,76119388,-2880612,26119388,84.0896415254,18.7323451525,19.1091204066,0,0,0,
Silent Hill,967,50000000,46982632,94704227,-3017368,44704227,84.0896415254,18.8599317529,19.108433164,76,0,0,
The Replacements,968,50000000,44737059,50054511,-5262941,54511,84.0896415254,18.5205690917,19.0970803638,82,0,0,
The Negotiator,969,50000000,44484065,48884065,-5515935,-1115935,84.0896415254,18.5099207832,19.0957932022,91,0,0,
Beverly Hills Cop III,970,50000000,42586861,119180938,-7413139,69180938,84.0896415254,19.0064163068,19.0860876052,93,0,0,
Gremlins 2: The New Batch,971,50000000,41476097,41476097,-8523903,-8523903,84.0896415254,18.4397609438,19.080361199,60,0,0,
The Peacemaker,972,50000000,41256277,62960505,-8743723,12960505,84.0896415254,18.6310287565,19.079224047,97,0,0,
Out of Time,973,50000000,41083108,55489826,-8916892,5489826,84.0896415254,18.5685839605,19.078327314,30,0,0,
Bridget Jones: The Edge Of Reason,974,50000000,40203020,263894551,-9796980,213894551,84.0896415254,19.5973176839,19.0737574236,57,0,0,
The Beach,975,50000000,39778599,39778599,-10221401,-10221401,84.0896415254,18.4229665396,19.071546115,58,0,0,
The Adventures of Sharkboy and Lavagirl in 3-D,976,50000000,39177541,69425823,-10822459,19425823,84.0896415254,18.6820912076,19.0684061066,76,0,0,
On Deadly Ground,977,50000000,38590458,38590458,-11409542,-11409542,84.0896415254,18.4110414348,19.0653295576,2,0,0,
Ninja Assassin,978,50000000,38122883,62209892,-11877117,12209892,84.0896415254,18.6249279507,19.0628724889,40,0,0,
Raising Helen,979,50000000,37485528,43340302,-12514472,-6659698,84.0896415254,18.4578854264,19.0595134869,0,0,0,
For Love of the Game,980,50000000,35188640,46112640,-14811360,-3887360,84.0896415254,18.4842458103,19.0473139121,32,0,0,
Jack Frost,981,50000000,34545030,34545030,-15454970,-15454970,84.0896415254,18.36933768,19.0438686094,32,0,0,
Marmaduke,982,50000000,33644788,84023611,-16355212,34023611,84.0896415254,18.7886091011,19.0390295318,49,0,0,
Striptease,983,50000000,32758418,112958418,-17241582,62958418,84.0896415254,18.9711615635,19.0342420321,13,0,0,
Hereafter,984,50000000,32746941,105246941,-17253059,55246941,84.0896415254,18.9256724817,19.0341798915,67,0,0,
Murder by Numbers,985,50000000,31874869,56643267,-18125131,6643267,84.0896415254,18.5784833959,19.0294468489,79,0,0,
Assassins,986,50000000,30272938,83272938,-19727062,33272938,84.0896415254,18.7833996464,19.0206937999,4,0,0,
Defiance,987,50000000,28644813,42268745,-21355187,-7731255,84.0896415254,18.4475075362,19.0117184186,5,0,0,
Hannibal Rising,988,50000000,27669725,80583311,-22330275,30583311,84.0896415254,18.7645083846,19.0063042153,41,0,0,
The Story of Us,989,50000000,27100030,27100030,-22899970,-22899970,84.0896415254,18.2877237236,19.0031273484,50,0,0,
The Host,990,50000000,26623701,64477051,-23376299,14477051,84.0896415254,18.6432424701,19.0004633618,18,0,0,
Basic,991,50000000,26599248,42598498,-23400752,-7401502,84.0896415254,18.4507126382,19.0003264107,32,0,0,
Run All Night,992,50000000,26461644,66961644,-23538356,16961644,84.0896415254,18.6629355935,18.999555398,64,0,0,
Blood Work,993,50000000,26199517,26199517,-23800483,-23800483,84.0896415254,18.2773847929,18.9980850202,40,0,0,
The International,994,50000000,25450527,53850527,-24549473,3850527,84.0896415254,18.5543438567,18.9938716742,68,0,0,
Escape from L.A.,995,50000000,25329895,25329895,-24670105,-24670105,84.0896415254,18.2672980343,18.9931914116,91,0,0,
Twisted,996,50000000,25195050,40119848,-24804950,-9880152,84.0896415254,18.4263654554,18.9924304516,22,0,0,
The Life Aquatic with Steve Zissou,997,50000000,24006726,34806726,-25993274,-15193274,84.0896415254,18.3720887243,18.985699322,70,0,0,
The Iron Giant,998,50000000,23159305,31333917,-26840695,-18666083,84.0896415254,18.3349502809,18.9808713724,89,0,0,
Your Highness,999,50000000,21596445,26121638,-28403555,-23878362,84.0896415254,18.2764856096,18.9719058052,53,0,0,
Dream House,1000,50000000,21302340,39932340,-28697660,-10067660,84.0896415254,18.4244992642,18.9702096067,30,0,0,
Gamer,1001,50000000,20534907,42002029,-29465093,-7997971,84.0896415254,18.4449075994,18.9657699763,7,0,0,
The Life of David Gale,1002,50000000,19694635,28920188,-30305365,-21079812,84.0896415254,18.3083004249,18.9608862569,57,0,0,
Beautiful Creatures,1003,50000000,19452138,60282876,-30547862,10282876,84.0896415254,18.6090930313,18.9594724013,25,0,0,
Man of the House,1004,50000000,19118247,21518247,-30881753,-28481753,84.0896415254,18.221845451,18.9575224047,20,0,0,
Into the Blue,1005,50000000,18472363,41672363,-31527637,-8327637,84.0896415254,18.4416846593,18.9537394744,98,0,0,
Eastern Promises,1006,50000000,17181265,56077088,-32818735,6077088,84.0896415254,18.5736363958,18.9461343709,72,0,0,
Baby's Day Out,1007,50000000,16581575,16581575,-33418425,-33418425,84.0896415254,18.1597291024,18.9425821799,60,0,0,
The Messenger: The Story of Joan of Arc,1008,50000000,14271297,14271297,-35728703,-35728703,84.0896415254,18.1292789487,18.9287783581,60,0,0,
Fair Game,1009,50000000,11497497,26097497,-38502503,-23902503,84.0896415254,18.2762067157,18.9119492765,77,0,0,
Drive Angry,1010,50000000,10721033,40886464,-39278967,-9113536,84.0896415254,18.4339592531,18.9071871626,79,0,0,
Mad City,1011,50000000,10556196,10556196,-39443804,-39443804,84.0896415254,18.0782811071,18.9061732797,98,0,0,
The Scarlet Letter,1012,50000000,10359006,10359006,-39640994,-39640994,84.0896415254,18.0755001717,18.9049590473,85,0,0,
Domino,1013,50000000,10169202,22969202,-39830798,-27030798,84.0896415254,18.2393919818,18.9037889014,57,0,0,
Jade,1014,50000000,9812870,9812870,-40187130,-40187130,84.0896415254,18.0677574966,18.9015884014,10,0,0,
Street Fighter: The Legend of Chun-Li,1015,50000000,9135036,12335036,-40864964,-37664964,84.0896415254,18.1030242676,18.8973890777,73,0,0,
Death to Smoochy,1016,50000000,8355815,8374062,-41644185,-41625938,84.0896415254,18.0470674965,18.892539751,22,0,0,
The Boat That Rocked,1017,50000000,8017467,37472651,-41982533,-12527349,84.0896415254,18.3996909209,18.8904267651,88,0,0,
The Big Bounce,1018,50000000,6471394,6626115,-43528606,-43373885,84.0896415254,18.0213421853,18.8807143057,51,0,0,
What Planet Are You From?,1019,50000000,6291602,6291602,-43708398,-43708398,84.0896415254,18.0163426607,18.8795787017,56,0,0,
Child 44,1020,50000000,1224330,3434330,-48775670,-46565670,84.0896415254,17.9725884506,18.84703058,58,0,0,
Outlander,1021,50000000,166003,1250617,-49833997,-48749383,84.0896415254,17.9378084111,18.8400969087,2,0,0,
The One,1024,49000000,43905746,43905746,-5094254,-5094254,83.6660026534,18.4728555358,19.0979376756,7,0,0,
Chappie,1025,49000000,31569268,105002056,-17430732,56002056,83.6660026534,18.9302193279,19.0332174128,54,0,0,
The Adventures of Ford Fairlane,1026,49000000,20423389,20423389,-28576611,-28576611,83.6660026534,18.2206875313,18.9709080838,46,0,0,
Anna Karenina,1027,49000000,12816367,71004627,-36183633,22004627,83.6660026534,18.7017525341,18.9260375691,61,0,0,
Indiana Jones and the Last Crusade,1028,48000000,195705225,472705225,147705225,424705225,83.2358290058,20.0980678552,19.6724333336,9,0,0,
The Ring,1029,48000000,129094024,248218486,81094024,200218486,83.2358290058,19.5542377192,19.4610823418,38,0,0,
Traffic,1030,48000000,124107476,208300000,76107476,160300000,83.2358290058,19.4167073377,19.4433071851,59,0,0,
Panic Room,1031,48000000,95308367,196308367,47308367,148308367,83.2358290058,19.3714061735,19.3339657151,35,0,0,
Taken 3,1032,48000000,89256424,327656424,41256424,279656424,83.2358290058,19.7819307623,19.3093854359,60,0,0,
The Thomas Crown Affair,1033,48000000,69304264,124304264,21304264,76304264,83.2358290058,19.0453055103,19.2237830015,69,0,0,
The Bone Collector,1034,48000000,66488090,151463090,18488090,103463090,83.2358290058,19.1810815003,19.2110880701,79,0,0,
Three Kings,1035,48000000,60652036,107752036,12652036,59752036,83.2358290058,18.9524981583,19.1842554325,29,0,0,
The Tooth Fairy,1036,48000000,60022256,112610386,12022256,64610386,83.2358290058,18.9806429177,19.1813163576,52,0,0,
Rat Race,1037,48000000,56607223,86607223,8607223,38607223,83.2358290058,18.8198424608,19.1652267974,50,0,0,
3:10 to Yuma,1038,48000000,53606916,71171825,5606916,23171825,83.2358290058,18.7105259777,19.1508743381,68,0,0,
K-PAX,1039,48000000,50315140,50315140,2315140,2315140,83.2358290058,18.5408199529,19.1348869241,76,0,0,
Kate and Leopold,1040,48000000,47095453,70937778,-904547,22937778,83.2358290058,18.7087728824,19.1189984046,77,0,0,
Bedazzled,1041,48000000,37879996,90376224,-10120004,42376224,83.2358290058,18.8448136266,19.0720748561,44,0,0,
Out of Sight,1042,48000000,37474810,77474810,-10525190,29474810,83.2358290058,18.7566174944,19.0699603125,47,0,0,
The Cotton Club,1043,48000000,25928721,25928721,-22071279,-22071279,83.2358290058,18.2971445243,19.0077451593,53,0,0,
Rambo,1044,47500000,42754105,112214531,-4745895,64714531,83.0182171336,18.981237649,19.0997058052,13,0,0,
Dick Tracy,1045,47000000,99098477,158098477,52098477,111098477,82.7988804296,19.2161530736,19.3530014978,65,0,0,
The Cable Guy,1046,47000000,60154431,102739932,13154431,55739932,82.7988804296,18.9286433172,19.1865938451,9,0,0,
Riding in Cars with Boys,1047,47000000,29781453,29781453,-17218547,-17218547,82.7988804296,18.3505982971,19.0343667403,50,0,0,
Happily N'Ever After,1048,47000000,15849032,37923818,-31150968,-9076182,82.7988804296,18.434327798,18.9559473565,100,0,0,
Solaris,1049,47000000,14970038,14970038,-32029962,-32029962,82.7988804296,18.1775931255,18.9507874414,46,0,0,
Jonah Hex,1050,47000000,10547117,11022696,-36452883,-35977304,82.7988804296,18.1259463692,18.9244118894,6,0,0,
Mary Reilly,1051,47000000,5615008,12807914,-41384992,-34192086,82.7988804296,18.1496349318,18.8941553985,72,0,0,
My Best Friend's Wedding,1052,46000000,126805112,298915378,80805112,252915378,82.3549026053,19.710920103,19.4600610575,36,0,0,
America's Sweethearts,1053,46000000,93607673,160648493,47607673,114648493,82.3549026053,19.2320496862,19.3351658227,91,0,0,
Star Trek: First Contact,1054,46000000,91968563,149940675,45968563,103940675,82.3549026053,19.1833116216,19.3285758672,100,0,0,
Insomnia,1055,46000000,67263182,113622499,21263182,67622499,82.3549026053,18.9977026821,19.223598963,1,0,0,
Prisoners,1056,46000000,61002302,113402302,15002302,67402302,82.3549026053,18.9964653605,19.195148076,50,0,0,
Courage Under Fire,1057,46000000,58918501,100748262,12918501,54748262,82.3549026053,18.9226583634,19.1854963828,49,0,0,
Inchon,1058,46000000,4408636,4408636,-41591364,-41591364,82.3549026053,18.047569722,18.892869216,92,0,0,
Liar Liar,1059,45000000,181395380,302695380,136395380,257695380,81.9036258813,19.7239891298,19.6395521144,100,0,0,
A Bug's Life,1060,45000000,162792677,363089431,117792677,318089431,81.9036258813,19.8758938775,19.5829999519,44,0,0,
Taken 2,1061,45000000,139854287,377807404,94854287,332807404,81.9036258813,19.9096617527,19.5085542713,83,0,0,
The Flintstones,1062,45000000,125388575,353357367,80388575,308357367,81.9036258813,19.8529222054,19.4585867892,71,0,0,
Scary Movie 3,1063,45000000,110000082,155200000,65000082,110200000,81.9036258813,19.2120893905,19.4025397279,45,0,0,
Miss Congeniality,1064,45000000,106807667,213420951,61807667,168420951,81.9036258813,19.4462605594,19.3905084058,17,0,0,
Journey to the Center of the Earth,1065,45000000,101704370,243180937,56704370,198180937,81.9036258813,19.5476575265,19.3709696947,72,0,0,
The Pelican Brief,1066,45000000,100768056,187995859,55768056,142995859,81.9036258813,19.3506617391,19.3673430623,77,0,0,
The Princess Diaries 2: Royal Engagement,1067,45000000,95149435,122071435,50149435,77071435,81.9036258813,19.0494050074,19.3452997235,8,0,0,
The Bucket List,1068,45000000,93466502,174810815,48466502,129810815,81.9036258813,19.2972366277,19.3386014388,3,0,0,
The Client,1069,45000000,92112663,117612663,47112663,72612663,81.9036258813,19.025340395,19.3331802342,25,0,0,
The Muppets,1070,45000000,88625922,160971922,43625922,115971922,81.9036258813,19.2379117971,19.31908137,34,0,0,
Patriot Games,1071,45000000,83287363,178100000,38287363,133100000,81.9036258813,19.3108338119,19.2971018777,61,0,0,
Monster-in-Law,1072,45000000,82931301,155931301,37931301,110931301,81.9036258813,19.2153982099,19.2956185988,36,0,0,
Training Day,1073,45000000,76261036,104505362,31261036,59505362,81.9036258813,18.951047808,19.2674171196,53,0,0,
Galaxy Quest,1074,45000000,71423726,90523726,26423726,45523726,81.9036258813,18.8651996796,19.2464559899,51,0,0,
Scary Movie 2,1075,45000000,71277420,141189101,26277420,96189101,81.9036258813,19.1464855274,19.2458151174,31,0,0,
Blade,1076,45000000,70001065,131096877,25001065,86096877,81.9036258813,19.0964127519,19.2402067371,18,0,0,
Coach Carter,1077,45000000,67264877,76665507,22264877,31665507,81.9036258813,18.7721524174,19.2280767132,13,0,0,
The Bounty Hunter,1078,45000000,67061228,135808837,22061228,90808837,81.9036258813,19.1201035863,19.2271679893,68,0,0,
Changing Lanes,1079,45000000,66790248,66790248,21790248,21790248,81.9036258813,18.7001327169,19.2259575386,84,0,0,
Anaconda,1080,45000000,65557989,136957989,20557989,91957989,81.9036258813,19.1257971616,19.2204345585,35,0,0,
Underworld: Evolution,1081,45000000,62318875,113417762,17318875,68417762,81.9036258813,19.002158684,19.2057696922,93,0,0,
Coyote Ugly,1082,45000000,60786269,115786269,15786269,70786269,81.9036258813,19.0153134269,19.1987552523,99,0,0,
Love Actually,1083,45000000,59472278,247967903,14472278,202967903,81.9036258813,19.5630487835,19.192701945,89,0,0,
Jack,1084,45000000,58617334,58617334,13617334,13617334,81.9036258813,18.636336943,19.1887436115,19,0,0,
The Specialist,1085,45000000,57344996,57344996,12344996,12344996,81.9036258813,18.6260287945,19.1828236087,94,0,0,
Tin Cup,1086,45000000,53854588,75854588,8854588,30854588,81.9036258813,18.7664300297,19.1664009675,70,0,0,
"Yours, Mine and Ours",1087,45000000,53359917,72359917,8359917,27359917,81.9036258813,18.7413876367,19.1640515275,91,0,0,
Kicking and Screaming,1088,45000000,52580895,55580895,7580895,10580895,81.9036258813,18.6115584011,19.1603403347,6,0,0,
The Hitchhiker's Guide to the Galaxy,1089,45000000,51019112,102746214,6019112,57746214,81.9036258813,18.9406432352,19.1528583937,63,0,0,
Resident Evil: Extinction,1090,45000000,50648679,146162920,5648679,101162920,81.9036258813,19.1702704583,19.1510755386,74,0,0,
Fat Albert,1091,45000000,48114556,48563556,3114556,3563556,81.9036258813,18.5518300342,19.1387930707,89,0,0,
Savages,1092,45000000,47323100,79020056,2323100,34020056,81.9036258813,18.7885844943,19.1349258939,16,0,0,
The River Wild,1093,45000000,46451705,93851705,1451705,48851705,81.9036258813,18.8863119971,19.1306507539,21,0,0,
Blended,1094,45000000,46290741,127990741,1290741,82990741,81.9036258813,19.0804830265,19.1298590467,69,0,0,
Last Holiday,1095,45000000,38399961,43343247,-6600039,-1656753,81.9036258813,18.5049620469,19.0902587509,23,0,0,
16 Blocks,1096,45000000,36883539,65583539,-8116461,20583539,81.9036258813,18.6909657182,19.0824655258,69,0,0,
The Indian in the Cupboard,1097,45000000,35621764,35621764,-9378236,-9378236,81.9036258813,18.4313437516,19.0759343723,15,0,0,
Cellular,1098,45000000,32003620,61475984,-12996380,16475984,81.9036258813,18.6591165781,19.0569662132,15,0,0,
The Ant Bully,1099,45000000,28142535,49610898,-16857465,4610898,81.9036258813,18.5609741973,19.0363195561,5,0,0,
Johnny English,1100,45000000,28013509,163126676,-16986491,118126676,81.9036258813,19.2473833331,19.0356221911,14,0,0,
Dune,1101,45000000,27447471,27447471,-17552529,-17552529,81.9036258813,18.3470095857,19.0325570864,4,0,0,
Aliens in the Attic,1102,45000000,25200412,59551283,-19799588,14551283,81.9036258813,18.6438364953,19.0202956948,1,0,0,
Across the Universe,1103,45000000,24343673,29367143,-20656327,-15632857,81.9036258813,18.3674633366,19.0155809035,82,0,0,
Revolutionary Road,1104,45000000,22911480,79564960,-22088520,34564960,81.9036258813,18.7923491363,19.0076493021,59,0,0,
Babylon A.D.,1105,45000000,22532572,70216497,-22467428,25216497,81.9036258813,18.725711988,19.0055403125,98,0,0,
Frankenstein,1106,45000000,22006296,112006296,-22993704,67006296,81.9036258813,18.9942362806,19.0026036786,23,0,0,
The Glimmer Man,1107,45000000,20301706,36301706,-24698294,-8698294,81.9036258813,18.4380485272,18.9930323827,30,0,0,
Multiplicity,1108,45000000,20101861,20101861,-24898139,-24898139,81.9036258813,18.2646361402,18.9919042269,77,0,0,
The Pledge,1109,45000000,19719930,29406132,-25280070,-15593868,81.9036258813,18.367874453,18.9897446207,58,0,0,
The Producers: The Movie Musical,1110,45000000,19398532,32952995,-25601468,-12047005,81.9036258813,18.4045842579,18.9879236741,67,0,0,
The Phantom,1111,45000000,17220599,17220599,-27779401,-27779401,81.9036258813,18.2303775103,18.9754959992,98,0,0,
Rebound,1112,45000000,16809014,17492014,-28190986,-27507986,81.9036258813,18.2336552129,18.9731299705,32,0,0,
The Ghost Writer,1113,45000000,15541549,65532491,-29458451,20532491,81.9036258813,18.6905760634,18.9658084852,74,0,0,
All the Pretty Horses,1114,45000000,15527125,18120267,-29472875,-26879733,81.9036258813,18.2412012528,18.965724856,16,0,0,
Bangkok Dangerous,1115,45000000,15298133,46598133,-29701867,1598133,81.9036258813,18.5344412557,18.9643962411,72,0,0,
Nixon,1116,45000000,13642684,34642684,-31357316,-10357316,81.9036258813,18.4216095726,18.9547384314,73,0,0,
Dredd,1117,45000000,13414714,41467606,-31585286,-3532394,81.9036258813,18.4875713219,18.9534011286,40,0,0,
Deep Rising,1118,45000000,11146409,11146409,-33853591,-33853591,81.9036258813,18.1540639133,18.9399966035,67,0,0,
Johnny English Reborn,1119,45000000,8305970,164539660,-36694030,119539660,81.9036258813,19.2535459616,18.9229536433,29,0,0,
Miracle at St. Anna,1120,45000000,7916887,9110458,-37083113,-35889542,81.9036258813,18.1271241168,18.920596317,25,0,0,
Big Trouble,1121,45000000,7262288,8488871,-37737712,-36511129,81.9036258813,18.1187525153,18.9166177341,28,0,0,
Man cheng jin dai huang jin jia,1122,45000000,6566773,75566773,-38433227,30566773,81.9036258813,18.7643911149,18.9123730517,4,0,0,
Love in the Time of Cholera,1123,45000000,4617608,31077418,-40382392,-13922582,81.9036258813,18.3853401575,18.9003805196,34,0,0,
Pinocchio,1124,45000000,3681811,31681811,-41318189,-13318189,81.9036258813,18.3915819819,18.894571384,88,0,0,
Shadow Conspiracy,1125,45000000,2154540,2154540,-42845460,-42845460,81.9036258813,18.0291892783,18.8850174779,86,0,0,
Argo,1127,44500000,136025503,227140757,91525503,182640757,81.6751616592,19.4959936956,19.4972751551,49,0,0,
The Fugitive,1128,44000000,172494360,342333917,128494360,298333917,81.4447639858,19.8286978461,19.6159225872,47,0,0,
Rambo: First Blood Part II,1129,44000000,150415432,300400000,106415432,256400000,81.4447639858,19.7204642628,19.5467679596,60,0,0,
Sleepers,1130,44000000,53300852,165600852,9300852,121600852,81.4447639858,19.2624681382,19.1685157727,62,0,0,
Charlie St. Cloud,1131,44000000,31162545,48434366,-12837455,4434366,81.4447639858,18.559438774,19.0578069777,68,0,0,
The Juror,1132,44000000,22079985,22079985,-21920015,-21920015,81.4447639858,18.2988545998,19.0085857686,51,0,0,
The Interview,1133,44000000,6105175,12342632,-37894825,-31657368,81.4447639858,18.1823331194,18.9156604579,21,0,0,
Heaven's Gate,1134,44000000,3484331,3484331,-40515669,-40515669,81.4447639858,18.0630706917,18.8995552356,56,0,0,
The Heat,1135,43000000,159581587,229727774,116581587,186727774,80.9780125979,19.5098418977,19.5792049551,27,0,0,
Finding Forrester,1136,43000000,51768623,80013623,8768623,37013623,80.9780125979,18.8090937207,19.1659930728,19,0,0,
28 Days,1137,43000000,37035515,62063972,-5964485,19063972,80.9780125979,18.6793011938,19.0935070266,15,0,0,
Danny the Dog,1138,43000000,24537621,49037621,-18462379,6037621,80.9780125979,18.5732976454,19.0276104614,47,0,0,
The Sweetest Thing,1139,43000000,24430272,63078756,-18569728,20078756,80.9780125979,18.687105967,19.0270252149,17,0,0,
The Mechanic,1140,42500000,29121498,76347393,-13378502,33847393,80.7415779212,18.7873886342,19.0549417667,3,0,0,
The Firm,1141,42000000,158340892,270340892,116340892,228340892,80.5030477585,19.6408943516,19.5784490095,36,0,0,
21 Jump Street,1142,42000000,138447667,202812429,96447667,160812429,80.5030477585,19.4185981751,19.5139085222,68,0,0,
Notting Hill,1143,42000000,116089678,363728226,74089678,321728226,80.5030477585,19.8843491813,19.4360237326,88,0,0,
Chicken Run,1144,42000000,106793915,227793915,64793915,185793915,80.5030477585,19.506694527,19.4017670989,28,0,0,
Along Came Polly,1145,42000000,88073507,173044410,46073507,131044410,80.5030477585,19.3023578859,19.3289990927,25,0,0,
Boomerang,1146,42000000,65337168,126337168,23337168,84337168,80.5030477585,19.0874193167,19.2328479237,66,0,0,
Brüno,1147,42000000,60054530,130788243,18054530,88788243,80.5030477585,19.1100130823,19.2091192451,58,0,0,
Cleopatra,1148,42000000,57000000,71000000,15000000,29000000,80.5030477585,18.7532184075,19.1951374648,22,0,0,
Here Comes the Boom,1149,42000000,45290318,73239258,3290318,31239258,80.5030477585,18.7691486018,19.1396498456,66,0,0,
High Crimes,1150,42000000,41543207,63781100,-456793,21781100,80.5030477585,18.7000635375,19.1212231523,59,0,0,
The Mirror Has Two Faces,1151,42000000,41252428,41252428,-747572,-747572,80.5030477585,18.5132842641,19.1197789272,27,0,0,
Red Riding Hood,1152,42000000,37662162,90300442,-4337838,48300442,80.5030477585,18.8828455045,19.1017729697,9,0,0,
The Mothman Prophecies,1153,42000000,35228696,56438555,-6771304,14438555,80.5030477585,18.6429342754,19.0893816188,56,0,0,
Licence to Kill,1154,42000000,33197509,154697509,-8802491,112697509,80.5030477585,19.2233446706,19.0789198148,23,0,0,
One for the Money,1155,42000000,26414527,36197221,-15585473,-5802779,80.5030477585,18.4661077639,19.0431685653,80,0,0,
15 Minutes,1156,42000000,24375436,56331864,-17624564,14331864,80.5030477585,18.6420796223,19.032166341,37,0,0,
Lord of War,1157,42000000,24149632,60437727,-17850368,18437727,80.5030477585,18.6744541277,19.0309405033,27,0,0,
Super Mario Bros.,1158,42000000,20844907,20844907,-21155093,-21155093,80.5030477585,18.307457722,19.0128258305,44,0,0,
Man on a Ledge,1159,42000000,18620000,45688337,-23380000,3688337,80.5030477585,18.5529238735,19.0004426353,56,0,0,
Hero,1160,42000000,18207017,65507017,-23792983,23507017,80.5030477585,18.7130313444,18.9981271208,40,0,0,
The Warrior's Way,1161,42000000,5666340,8514325,-36333660,-33485675,80.5030477585,18.1588557052,18.925132061,9,0,0,
McHale's Navy,1162,42000000,4368453,4368453,-37631547,-37631547,80.5030477585,18.1034832798,18.91726407,78,0,0,
Micmacs,1163,42000000,1259693,11756922,-40740307,-30243078,80.5030477585,18.2001233957,18.8981626784,12,0,0,
8 Mile,1166,41000000,116724075,245769202,75724075,204769202,80.0195241015,19.5687796019,19.4419273353,57,0,0,
A Knights Tale,1167,41000000,56083966,100622586,15083966,59622586,80.0195241015,18.9517373033,19.1955244347,61,0,0,
The Medallion,1168,41000000,22108977,22108977,-18891023,-18891023,80.0195241015,18.3324965232,19.0252715256,46,0,0,
The Big Year,1169,41000000,7204138,7204138,-33795862,-33795862,80.0195241015,18.1548173046,18.9403399902,29,0,0,
The Sixth Sense,1170,40000000,293506292,672806292,253506292,632806292,79.5270728767,20.4265518109,19.9367912582,52,0,0,
The Wedding Crashers,1171,40000000,209218368,283218368,169218368,243218368,79.5270728767,19.6838709027,19.7321429566,93,0,0,
Fifty Shades of Grey,1173,40000000,166167230,570455257,126167230,530455257,79.5270728767,20.2783925766,19.6088550598,76,0,0,
The Proposal,1174,40000000,163958031,314709717,123958031,274709717,79.5270728767,19.7691692839,19.6020991555,22,0,0,
American Hustle,1175,40000000,150117807,257878294,110117807,217878294,79.5270728767,19.6095252992,19.5587032407,29,0,0,
Cheaper by the Dozen,1176,40000000,138614544,189714544,98614544,149714544,79.5270728767,19.3768257806,19.5211442015,71,0,0,
Lucy,1177,40000000,126573960,450573960,86573960,410573960,79.5270728767,20.0713070516,19.4802586096,77,0,0,
Lone Survivor,1178,40000000,125095601,149804632,85095601,109804632,79.5270728767,19.210295952,19.4751214136,98,0,0,
Double Jeopardy,1179,40000000,116735231,177835231,76735231,137835231,79.5270728767,19.330089743,19.4455623555,55,0,0,
Spy Kids 3-D: Game Over,1180,40000000,111760631,167851995,71760631,127851995,79.5270728767,19.2890503294,19.4275503059,34,0,0,
Back to the Future Part II,1181,40000000,109116271,322666269,69116271,282666269,79.5270728767,19.7896165916,19.4178418729,8,0,0,
A Time to Kill,1182,40000000,108706165,152206165,68706165,112206165,79.5270728767,19.2211403655,19.4163277425,23,0,0,
A League of Their Own,1183,40000000,107404544,132310685,67404544,92310685,79.5270728767,19.1275381435,19.4115068552,63,0,0,
The Social Network,1184,40000000,96962694,224922135,56962694,184922135,79.5270728767,19.5037474132,19.3719679526,34,0,0,
42,1185,40000000,95020213,97470701,55020213,57470701,79.5270728767,18.9390038493,19.3644369585,86,0,0,
Julie & Julia,1186,40000000,94125426,126646119,54125426,86646119,79.5270728767,19.0992033093,19.360948699,72,0,0,
He's Just Not That Into You,1187,40000000,93953653,181053657,53953653,141053657,79.5270728767,19.3429690504,19.3602776605,52,0,0,
Scary Movie 4,1188,40000000,90710620,178710620,50710620,138710620,79.5270728767,19.333609278,19.3475233723,72,0,0,
Get Hard,1189,40000000,90411453,106511453,50411453,66511453,79.5270728767,18.9914438547,19.3463385634,42,0,0,
Scream 3,1190,40000000,89138076,161838076,49138076,121838076,79.5270728767,19.2634899081,19.3412797698,0,0,0,
Back to the Future Part III,1191,40000000,87666629,243700000,47666629,203700000,79.5270728767,19.5653819072,19.335402045,9,0,0,
Dumb and Dumber To,1192,40000000,86208010,141208010,46208010,101208010,79.5270728767,19.1704835131,19.3295412641,95,0,0,
The Other Woman,1193,40000000,83911193,195111193,43911193,155111193,79.5270728767,19.3973567655,19.3202423776,48,0,0,
Eight Below,1194,40000000,81612565,120612565,41612565,80612565,79.5270728767,19.0681127645,19.3108487738,12,0,0,
The Talented Mr. Ripley,1195,40000000,81292135,128792135,41292135,88792135,79.5270728767,19.1100326165,19.3095322644,41,0,0,
Bram Stoker's Dracula,1196,40000000,78142084,211481986,38142084,171481986,79.5270728767,19.4571772738,19.2964969418,77,0,0,
Ray,1197,40000000,75305995,124823094,35305995,84823094,79.5270728767,19.0899108582,19.2846136825,74,0,0,
The Intern,1198,40000000,74642532,187852884,34642532,147852884,79.5270728767,19.3696443602,19.2818132612,0,0,0,
Sin City,1199,40000000,74103820,158753820,34103820,118753820,79.5270728767,19.2501232652,19.2795336202,72,0,0,
Vantage Point,1200,40000000,72266306,150886329,32266306,110886329,79.5270728767,19.2151950467,19.2717185748,47,0,0,
The Last of the Mohicans,1201,40000000,71759298,71759298,31759298,31759298,79.5270728767,18.7728121618,19.2695514482,32,0,0,
"I Love You, Man",1202,40000000,71440011,91729503,31440011,51729503,79.5270728767,18.9042158152,19.2681842918,79,0,0,
Shallow Hal,1203,40000000,70836296,70836296,30836296,30836296,79.5270728767,18.7663005707,19.2655941223,100,0,0,
JFK,1204,40000000,70405498,205400000,30405498,165400000,79.5270728767,19.435368675,19.2637417229,0,0,0,
Big Momma's House 2,1205,40000000,70165972,137047376,30165972,97047376,79.5270728767,19.1506304181,19.2627102926,68,0,0,
Bridge of Spies,1206,40000000,67822048,95422048,27822048,55422048,79.5270728767,18.9267287129,19.2525605069,63,0,0,
The Mexican,1207,40000000,66808615,145238250,26808615,105238250,79.5270728767,19.1893457581,19.2481399824,38,0,0,
The Final Destination,1208,40000000,66477700,187384627,26477700,147384627,79.5270728767,19.3678298954,19.2466923117,34,0,0,
17 Again,1209,40000000,64167069,139474906,24167069,99474906,79.5270728767,19.1622615871,19.2365250441,14,0,0,
Get Him to the Greek,1211,40000000,60974475,91276824,20974475,51276824,79.5270728767,18.9014206946,19.2223046617,58,0,0,
Behind Enemy Lines,1212,40000000,58855732,58855732,18855732,18855732,79.5270728767,18.6776920454,19.2127545254,49,0,0,
The Lincoln Lawyer,1213,40000000,58009200,87145086,18009200,47145086,79.5270728767,18.8755410903,19.2089131745,14,0,0,
Shall We Dance?,1214,40000000,57887882,118097882,17887882,78097882,79.5270728767,19.0548638321,19.2083614528,75,0,0,
Invincible,1215,40000000,57806952,58501127,17806952,18501127,79.5270728767,18.6749459068,19.2079932356,17,0,0,
Escape From Planet Earth,1216,40000000,57012977,74156610,17012977,34156610,79.5270728767,18.7895292525,19.2043735811,63,0,0,
Spawn,1217,40000000,54967359,87937226,14967359,47937226,79.5270728767,18.8805549181,19.1949869935,19,0,0,
Small Soldiers,1218,40000000,54452676,71052676,14452676,31052676,79.5270728767,18.7678308968,19.1926113643,82,0,0,
Horrible Bosses 2,1219,40000000,54445357,105945357,14445357,65945357,79.5270728767,18.9882397523,19.1925775412,65,0,0,
The Count of Monte Cristo,1220,40000000,54228104,75389090,14228104,35389090,79.5270728767,18.798016108,19.1915730332,94,0,0,
The Prestige,1221,40000000,53089891,104407366,13089891,64407366,79.5270728767,18.9794825322,19.1862937477,3,0,0,
The Lake House,1222,40000000,52330111,114830111,12330111,74830111,79.5270728767,19.0373806576,19.1827541432,81,0,0,
Predators,1223,40000000,52000688,127234389,12000688,87234389,79.5270728767,19.1021835462,19.1812155503,18,0,0,
The Odd Life of Timothy Green,1224,40000000,51853450,52685425,11853450,12685425,79.5270728767,18.6287972893,19.1805270989,26,0,0,
Apocalypto,1225,40000000,50866635,121032272,10866635,81032272,79.5270728767,19.0703070518,19.175900702,10,0,0,
Music and Lyrics,1226,40000000,50572589,146300356,10572589,106300356,79.5270728767,19.1942579326,19.1745180031,2,0,0,
The Living Daylights,1227,40000000,50096813,190111813,10096813,150111813,79.5270728767,19.3783516058,19.1722766939,48,0,0,
Secret Window,1228,40000000,47958031,92111551,7958031,52111551,79.5270728767,18.9065687521,19.1621386976,15,0,0,
The Skeleton Key,1229,40000000,47806295,92155498,7806295,52155498,79.5270728767,18.9068390559,19.1614155374,70,0,0,
Jersey Boys,1230,40000000,47047013,65282732,7047013,25282732,79.5270728767,18.7262000873,19.1577889902,40,0,0,
Legal Eagles,1231,40000000,46210024,46210024,6210024,6210024,79.5270728767,18.5747765595,19.1537759933,9,0,0,
Made of Honor,1232,40000000,46012734,106548738,6012734,66548738,79.5270728767,18.9916545279,19.1528277239,58,0,0,
The Rainmaker,1233,40000000,45856732,45856732,5856732,5856732,79.5270728767,18.5717435814,19.152077267,83,0,0,
Medicine Man,1234,40000000,44948240,44948240,4948240,4948240,79.5270728767,18.5639017578,19.1476956872,34,0,0,
Amistad,1235,40000000,44175394,58212953,4175394,18212953,79.5270728767,18.6727086566,19.143953144,18,0,0,
A Million Ways to Die in The West,1236,40000000,42720965,86760995,2720965,46760995,79.5270728767,18.8731009177,19.1368717934,11,0,0,
Final Destination 5,1237,40000000,42587643,157887643,2587643,117887643,79.5270728767,19.2463370417,19.1362201567,27,0,0,
Fever Pitch,1238,40000000,42071069,50071069,2071069,10071069,79.5270728767,18.6073371501,19.1336912853,32,0,0,
Aliens vs. Predator - Requiem,1239,40000000,41797066,128884494,1797066,88884494,79.5270728767,19.1104960601,19.1323473122,95,0,0,
Sex Tape,1240,40000000,38543473,126069509,-1456527,86069509,79.5270728767,19.0962734983,19.1162489615,29,0,0,
Scream 4,1241,40000000,38180928,95989590,-1819072,55989590,79.5270728767,18.9301444328,19.1144389828,50,0,0,
Ri¢hie Ri¢h,1242,40000000,38059575,38059575,-1940425,-1940425,79.5270728767,18.5023512062,19.1138324046,41,0,0,
Autumn in New York,1243,40000000,37752931,90717684,-2247069,50717684,79.5270728767,18.8979573981,19.1122980148,70,0,0,
Paul,1244,40000000,37412945,101162106,-2587055,61162106,79.5270728767,18.9607487005,19.1105940312,84,0,0,
The Guilt Trip,1245,40000000,37134215,37134215,-2865785,-2865785,79.5270728767,18.4937867437,19.1091948886,62,0,0,
Colombiana,1246,40000000,36665854,72295262,-3334146,32295262,79.5270728767,18.7765739105,19.1068394369,60,0,0,
8MM,1247,40000000,36283501,96238885,-3716499,56238885,79.5270728767,18.9316411207,19.1049124092,40,0,0,
Hanging Up,1248,40000000,36037909,51867723,-3962091,11867723,79.5270728767,18.6221344828,19.1036726842,0,0,0,
Mickey Blue Eyes,1249,40000000,33864342,53864342,-6135658,13864342,79.5270728767,18.6383258787,19.0926332101,29,0,0,
Pay it Forward,1250,40000000,33508922,55696705,-6491078,15696705,79.5270728767,18.6529580315,19.0908163935,4,0,0,
The Doors,1251,40000000,33404794,33404794,-6595206,-6595206,79.5270728767,18.4585066002,19.0902834919,1,0,0,
Arthur,1252,40000000,33035397,47787943,-6964603,7787943,79.5270728767,18.588211665,19.0883907146,93,0,0,
Drillbit Taylor,1253,40000000,32862104,49686263,-7137896,9686263,79.5270728767,18.604139196,19.0875015312,48,0,0,
Extremely Loud and Incredibly Close,1254,40000000,31847881,55247881,-8152119,15247881,79.5270728767,18.6493937411,19.0822815387,79,0,0,
The Shadow,1255,40000000,31835600,31835600,-8164400,-8164400,79.5270728767,18.4432818246,19.0822181637,62,0,0,
Morning Glory,1256,40000000,31011732,59795070,-8988268,19795070,79.5270728767,18.6849302457,19.0779574686,39,0,0,
Get Rich or Die Tryin',1257,40000000,30981850,46666955,-9018150,6666955,79.5270728767,18.5786856753,19.0778025899,76,0,0,
The Art of War,1258,40000000,30199105,30199105,-9800895,-9800895,79.5270728767,18.4271532223,19.0737370481,83,0,0,
Grudge Match,1259,40000000,29807260,69807260,-10192740,29807260,79.5270728767,18.7589905912,19.071695598,63,0,0,
Bless the Child,1260,40000000,29374178,40435694,-10625822,435694,79.5270728767,18.5240126274,19.0694344505,39,0,0,
Rent,1261,40000000,29077547,31670620,-10922453,-8329380,79.5270728767,18.4416675914,19.0678827665,70,0,0,
The Out-of-Towners,1262,40000000,28544120,28544120,-11455880,-11455880,79.5270728767,18.4105734571,19.0650863245,46,0,0,
The Island of Dr. Moreau,1263,40000000,27663982,27663982,-12336018,-12336018,79.5270728767,18.401642909,19.0604551169,72,0,0,
The Musketeer,1264,40000000,27053815,27053815,-12946185,-12946185,79.5270728767,18.3954045455,19.0572318373,29,0,0,
The Other Boleyn Girl,1265,40000000,26814957,78269970,-13185043,38269970,79.5270728767,18.8175773269,19.0559672065,84,0,0,
Sweet November,1266,40000000,25178165,65644290,-14821835,25644290,79.5270728767,18.7288602905,19.0472579334,13,0,0,
The Reaping,1267,40000000,25126214,62226214,-14873786,22226214,79.5270728767,18.7034240609,19.0469802594,28,0,0,
Season of the Witch,1268,40000000,24827228,91126600,-15172772,51126600,79.5270728767,18.9004913894,19.0453807024,78,0,0,
Renaissance Man,1269,40000000,23822558,23822558,-16177442,-16177442,79.5270728767,18.361703265,19.0399869575,61,0,0,
Quest for Camelot,1270,40000000,22717758,38117758,-17282242,-1882242,79.5270728767,18.5028872628,19.0340218668,60,0,0,
City by the Sea,1271,40000000,22433915,22433915,-17566085,-17566085,79.5270728767,18.3468636511,19.0324835651,68,0,0,
At First Sight,1272,40000000,22326247,22326247,-17673753,-17673753,79.5270728767,18.3457038145,19.0318994333,65,0,0,
Torque,1273,40000000,21176322,46176322,-18823678,6176322,79.5270728767,18.5744876276,19.0256393622,83,0,0,
The Fantastic Mr. Fox,1274,40000000,21002919,47085064,-18997081,7085064,79.5270728767,18.5822493231,19.024691965,29,0,0,
City Hall,1275,40000000,20231760,20231760,-19768240,-19768240,79.5270728767,18.3228694611,19.0204677877,65,0,0,
Showgirls,1276,40000000,20170437,37570437,-19829563,-2429563,79.5270728767,18.4978332391,19.0201311116,68,0,0,
Big Miracle,1277,40000000,20157300,25693998,-19842700,-14306002,79.5270728767,18.3813601219,19.020058972,63,0,0,
The Impossible,1278,40000000,19019882,169590606,-20980118,129590606,79.5270728767,19.2963196669,19.0137932182,88,0,0,
A Thousand Words,1279,40000000,18450127,18450127,-21549873,-21549873,79.5270728767,18.3030268513,19.0106397588,51,0,0,
Marie Antoinette,1280,40000000,15962471,60862471,-24037529,20862471,79.5270728767,18.6930921587,18.9967534678,97,0,0,
Get Carter,1281,40000000,14967182,19417182,-25032818,-20582818,79.5270728767,18.3138460757,18.9911432247,62,0,0,
Kiss of Death,1282,40000000,14924355,14924355,-25075645,-25075645,79.5270728767,18.2625591556,18.9909011098,8,0,0,
"Life, or Something Like It",1283,40000000,14448589,14448589,-25551411,-25551411,79.5270728767,18.2569708822,18.9882075004,46,0,0,
Ishtar,1284,40000000,14375181,14375181,-25624819,-25624819,79.5270728767,18.2561058555,18.9877912449,54,0,0,
Memoirs of an Invisible Man,1285,40000000,14358033,14358033,-25641967,-25641967,79.5270728767,18.2559036787,18.9876939832,64,0,0,
Amelia,1286,40000000,14246488,19722990,-25753512,-20277010,79.5270728767,18.3172431784,18.9870610807,31,0,0,
Cirque du Freak: The Vampire's Assistant,1287,40000000,14046595,39753957,-25953405,-246043,79.5270728767,18.5178455575,18.9859258916,25,0,0,
New York Minute,1288,40000000,14018364,21215882,-25981636,-18784118,79.5270728767,18.3336634471,18.9857654643,95,0,0,
The Deep End of the Ocean,1289,40000000,13432982,13432982,-26567018,-26567018,79.5270728767,18.2449361992,18.9824331221,98,0,0,
Alfie,1290,40000000,13395939,35195939,-26604061,-4804061,79.5270728767,18.4756061538,18.9822218773,91,0,0,
FearDotCom,1291,40000000,13208023,13208023,-26791977,-26791977,79.5270728767,18.2422507852,18.9811495623,36,0,0,
Soul Men,1292,40000000,12082391,12345883,-27917609,-27654117,79.5270728767,18.2318918189,18.9747021238,23,0,0,
The Gunman,1293,40000000,10664749,13644292,-29335251,-26355708,79.5270728767,18.2474521289,18.9665225041,7,0,0,
Universal Soldier II: The Return,1294,40000000,10447421,10717421,-29552579,-29282579,79.5270728767,18.212027487,18.9652626125,40,0,0,
Pandorum,1295,40000000,10330853,17033431,-29669147,-22966569,79.5270728767,18.2869627397,18.9645861911,37,0,0,
Duplex,1296,40000000,9652000,10070651,-30348000,-29929349,79.5270728767,18.2040272492,18.9606378224,4,0,0,
Paranoia,1297,40000000,7388654,16173593,-32611346,-23826407,79.5270728767,18.2770855667,18.9473598841,29,0,0,
Raise the Titanic,1298,40000000,7000000,7000000,-33000000,-33000000,79.5270728767,18.1651462495,18.9450619996,3,0,0,
Baahubali: The Beginning,1299,40000000,6738000,26738000,-33262000,-13262000,79.5270728767,18.3921602951,18.9435099615,40,0,0,
Impostor,1300,40000000,6114237,7974607,-33885763,-32025393,79.5270728767,18.1776513868,18.9398051851,85,0,0,
Extreme Ops,1301,40000000,4835968,12624471,-35164032,-27375529,79.5270728767,18.2352509176,18.9321698816,93,0,0,
Just Visiting,1302,40000000,4777007,16172200,-35222993,-23827800,79.5270728767,18.2770694856,18.9318162877,75,0,0,
Snowpiercer,1303,40000000,4563029,81185948,-35436971,41185948,79.5270728767,18.8369947231,18.9305319932,52,0,0,
Sunshine,1304,40000000,3675072,32017122,-36324928,-7982878,79.5270728767,18.4450549059,18.9251847866,47,0,0,
The Hudsucker Proxy,1305,40000000,2816518,14938149,-37183482,-25061851,79.5270728767,18.2627207129,18.9199873115,47,0,0,
Pirates,1306,40000000,1641825,6341825,-38358175,-33658175,79.5270728767,18.1566118986,18.9128319573,48,0,0,
Delgo,1307,40000000,915840,915840,-39084160,-39084160,79.5270728767,18.0833332726,18.9083840618,89,0,0,
The Hunting Party,1308,40000000,876671,7729552,-39123329,-32270448,79.5270728767,18.1745217835,18.9081435215,71,0,0,
Alex Rider: Operation Stormbreaker,1309,40000000,659210,20722450,-39340790,-19277550,79.5270728767,18.3282659805,18.9068070208,20,0,0,
Red Cliff,1310,40000000,627047,119627047,-39372953,79627047,79.5270728767,19.0629413317,18.9066091975,89,0,0,
The Last Shot,1311,40000000,463730,463730,-39536270,-39536270,79.5270728767,18.0769780385,18.9056040875,33,0,0,
The Warlords,1312,40000000,129078,38899792,-39870922,-1100208,79.5270728767,18.5100646161,18.9035413606,70,0,0,
Nomad,1313,40000000,79123,79123,-39920877,-39920877,79.5270728767,18.071539706,18.9032330828,78,0,0,
The Time Traveler's Wife,1317,39000000,63414846,102332135,24414846,63332135,79.0252997362,18.9733143676,19.2376202769,9,0,0,
Superman III,1318,39000000,59950623,59950623,20950623,20950623,79.0252997362,18.693763247,19.222197656,41,0,0,
Because I Said So,1319,39000000,42674040,69538833,3674040,30538833,79.0252997362,18.7641929631,19.1415178018,77,0,0,
Frankenweenie,1320,39000000,35287788,81150788,-3712212,42150788,79.0252997362,18.8433374265,19.1049340359,63,0,0,
Sgt. Bilko,1321,39000000,30141475,37741475,-8858525,-1258525,79.0252997362,18.5086157668,19.0786296497,57,0,0,
Serenity,1322,39000000,25335935,40140858,-13664065,1140858,79.0252997362,18.5303518557,19.0534262004,41,0,0,
Against the Ropes,1323,39000000,5881504,6429865,-33118496,-32570135,79.0252997362,18.1706811125,18.9443603502,96,0,0,
Yi dai zong shi,1324,38600000,6594959,57987299,-32005041,19387299,78.8218867245,18.6817945424,18.9509341013,1,0,0,
The Fast and the Furious,1325,38000000,144512310,206512310,106512310,168512310,78.5137822485,19.4465881086,19.5470820853,5,0,0,
Sweet Home Alabama,1326,38000000,127214072,182365114,89214072,144365114,78.5137822485,19.3560497468,19.4893676792,60,0,0,
The Ugly Truth,1327,38000000,88915214,205298907,50915214,167298907,78.5137822485,19.4422289226,19.3483328306,85,0,0,
Spy Kids 2: The Island of Lost Dreams,1328,38000000,85846296,119721296,47846296,81721296,78.5137822485,19.0738989583,19.3361215828,14,0,0,
Star Trek: Generations,1329,38000000,75510568,119839306,37510568,81839306,78.5137822485,19.0745128566,19.2938630737,0,0,0,
Paul Blart: Mall Cop 2,1330,38000000,71038190,107597242,33038190,69597242,78.5137822485,19.0087311741,19.2750088811,14,0,0,
Mouse Hunt,1331,38000000,61834214,61834214,23834214,23834214,78.5137822485,18.715470914,19.2350518558,13,0,0,
Water for Elephants,1332,38000000,58709717,116809717,20709717,78809717,78.5137822485,19.0586320725,19.2211162518,16,0,0,
Life as We Know It,1333,38000000,53374681,105887837,15374681,67887837,78.5137822485,18.9991916271,19.1968630827,1,0,0,
The Hurricane,1334,38000000,50699241,73956241,12699241,35956241,78.5137822485,18.8018974414,19.1844753825,5,0,0,
Riddick,1335,38000000,42025135,94763758,4025135,56763758,78.5137822485,18.9347849872,19.1432238786,32,0,0,
Heartbreakers,1336,38000000,40334024,57753825,2334024,19753825,78.5137822485,18.6846135239,19.1349793722,94,0,0,
Enough,1337,38000000,39177215,50970660,1177215,12970660,78.5137822485,18.6311110393,19.1293002878,41,0,0,
Push,1338,38000000,31811527,44411527,-6188473,6411527,78.5137822485,18.5765023328,19.092363442,22,0,0,
Rush,1339,38000000,26947624,98230839,-11052376,60230839,78.5137822485,18.9553073498,19.0672023772,99,0,0,
Angel Eyes,1340,38000000,24044532,29544532,-13955468,-8455468,78.5137822485,18.4404321347,19.051877268,26,0,0,
Joe Somebody,1341,38000000,22770864,24515990,-15229136,-13484010,78.5137822485,18.3898733523,19.0450788716,74,0,0,
The Ninth Gate,1342,38000000,18653746,58394308,-19346254,20394308,78.5137822485,18.6895205354,19.0227815105,3,0,0,
Extreme Measures,1343,38000000,17369541,17369541,-20630459,-20630459,78.5137822485,18.3133158098,19.0157235857,90,0,0,
Rock Star,1344,38000000,16991902,19317765,-21008098,-18682235,78.5137822485,18.3347742873,19.0136385875,74,0,0,
The Thing,1345,38000000,16928670,27501814,-21071330,-10498186,78.5137822485,18.4202011891,19.0132890494,100,0,0,
White Squall,1346,38000000,10229300,10229300,-27770700,-27770700,78.5137822485,18.2304827535,18.9755459572,75,0,0,
City of Ember,1347,38000000,7871693,17830244,-30128307,-20169756,78.5137822485,18.3184318933,18.9619173156,17,0,0,
Switchback,1348,38000000,6482195,6482195,-31517805,-31517805,78.5137822485,18.1841028168,18.9537971676,15,0,0,
Texas Rangers,1349,38000000,623374,623374,-37376626,-37376626,78.5137822485,18.1069779295,18.9188143336,32,0,0,
What to Expect When You're Expecting,1351,37500000,41152203,80652203,3652203,43152203,78.2542290037,18.8498782966,19.141411593,96,0,0,
The Master,1352,37500000,16247159,25116740,-21252841,-12383260,78.2542290037,18.4011612931,19.0122850015,75,0,0,
The Express,1353,37500000,9643725,9663628,-27856275,-27836372,78.2542290037,18.2296881422,18.9750545079,10,0,0,
We're the Millers,1355,37000000,150394119,267816276,113394119,230816276,77.9920670985,19.6481743077,19.5691475191,67,0,0,
The Town,1356,37000000,92186262,152566881,55186262,115566881,77.9920670985,19.2361213199,19.3650829516,64,0,0,
Dolphin Tale,1357,37000000,72286779,96068724,35286779,59068724,77.9920670985,18.9484753724,19.2845326835,9,0,0,
Burn After Reading,1358,37000000,60355347,168167798,23355347,131167798,77.9920670985,19.3028686902,19.2329286162,100,0,0,
Nim's Island,1359,37000000,48006762,94081683,11006762,57081683,77.9920670985,18.9366844881,19.1765589522,27,0,0,
Creed,1360,37000000,48005293,50305293,11005293,13305293,77.9920670985,18.6338186858,19.1765520538,38,0,0,
Cop Out,1361,37000000,44875481,55909910,7875481,18909910,77.9920670985,18.6781109483,19.1617453366,74,0,0,
The Rite,1362,37000000,33047633,97143987,-3952367,60143987,77.9920670985,18.9547983648,19.1037217993,65,0,0,
Space Chimps,1363,37000000,30105968,67029956,-6894032,30029956,77.9920670985,18.7605770974,19.0887525949,57,0,0,
Magnolia,1364,37000000,22450975,48446802,-14549025,11446802,77.9920670985,18.6186873449,19.0487148171,77,0,0,
Aloha,1365,37000000,21052030,24935799,-15947970,-12064201,77.9920670985,18.4044094923,19.0412214838,33,0,0,
Gnomeo and Juliet,1367,36000000,99967670,193737977,63967670,157737977,77.4596669241,19.4071996017,19.3986646691,2,0,0,
John Q,1368,36000000,71026631,102226631,35026631,66226631,77.4596669241,18.9898330459,19.2834354664,66,0,0,
Blue Streak,1369,36000000,68208190,117448157,32208190,81448157,77.4596669241,19.0724766181,19.2714704052,34,0,0,
Never Say Never Again,1370,36000000,55432841,159932841,19432841,123932841,77.4596669241,19.2724674416,19.2153648687,60,0,0,
Hot Tub Time Machine,1371,36000000,50269859,65967750,14269859,29967750,77.4596669241,18.7601341896,19.1917661733,98,0,0,
Breakdown,1372,36000000,50129186,50129186,14129186,14129186,77.4596669241,18.6404540464,19.1911153337,70,0,0,
Dolphin Tale 2,1373,36000000,42024533,57824533,6024533,21824533,77.4596669241,18.7003919458,19.1528844608,72,0,0,
A Man Apart,1374,36000000,26500000,43797731,-9500000,7797731,77.4596669241,18.5882944436,19.0753018393,68,0,0,
Reindeer Games,1375,36000000,23360779,23360779,-12639221,-12639221,77.4596669241,18.3985478179,19.0588547097,99,0,0,
Snow Falling on Cedars,1376,36000000,14378353,14378353,-21621647,-21621647,77.4596669241,18.302219172,19.0102418004,28,0,0,
Ghosts of Mississippi,1377,36000000,13052741,13052741,-22947259,-22947259,77.4596669241,18.2871834423,19.0028631901,99,0,0,
Gattaca,1378,36000000,12339633,12339633,-23660367,-23660367,77.4596669241,18.2790005255,18.9988712572,34,0,0,
Isn't She Great,1379,36000000,2954405,2954405,-33045595,-33045595,77.4596669241,18.1645573756,18.9447920766,63,0,0,
There Be Dragons,1380,36000000,1069334,4020990,-34930666,-31979010,77.4596669241,18.1782426444,18.9335681708,82,0,0,
Head of State,1382,35200000,37788228,38283765,2588228,3083765,77.0257021369,18.5476129712,19.1362230169,0,0,0,
The Hangover,1383,35000000,277322503,465764086,242322503,430764086,76.9160567313,20.1093259284,19.9119291422,30,0,0,
The Blind Side,1384,35000000,255959475,305705794,220959475,270705794,76.9160567313,19.7587193926,19.8626481847,32,0,0,
Batman,1385,35000000,248972777,409132777,213972777,374132777,76.9160567313,19.9987993245,19.8459893017,53,0,0,
Austin Powers: The Spy Who Shagged Me,1386,35000000,205957794,310250345,170957794,275250345,76.9160567313,19.7705719451,19.7368184719,26,0,0,
True Grit,1387,35000000,171050328,252084251,136050328,217084251,76.9160567313,19.6071039297,19.6385317461,0,0,0,
Rush Hour,1388,35000000,141153686,245266822,106153686,210266822,76.9160567313,19.5860698719,19.5459187577,45,0,0,
Lethal Weapon 3,1389,35000000,139799547,314768020,104799547,279768020,76.9160567313,19.7822167867,19.541513871,12,0,0,
Identity Thief,1390,35000000,134506920,175361578,99506920,140361578,76.9160567313,19.3402134948,19.5241088878,88,0,0,
The Devil Wears Prada,1391,35000000,124740460,326073155,89740460,291073155,76.9160567313,19.8107763637,19.4911739749,96,0,0,
Horrible Bosses,1392,35000000,117538559,212417601,82538559,177417601,76.9160567313,19.4780120543,19.4661730885,21,0,0,
Spy Kids,1393,35000000,112692062,197692062,77692062,162692062,76.9160567313,19.4255034775,19.4489899568,24,0,0,
Trainwreck,1394,35000000,110038130,139387096,75038130,104387096,76.9160567313,19.1853917324,19.4394538773,91,0,0,
Saving Mr. Banks,1395,35000000,83299761,114962525,48299761,79962525,76.9160567313,19.0647047317,19.3379353392,98,0,0,
Star Trek: The Motion Picture,1396,35000000,82258456,139000000,47258456,104000000,76.9160567313,19.1835882974,19.3337654501,98,0,0,
21,1397,35000000,81159365,157852532,46159365,122852532,76.9160567313,19.2678476272,19.3293452137,93,0,0,
What Happens in Vegas...,1398,35000000,80277646,218535708,45277646,183535708,76.9160567313,19.4990425351,19.325785008,88,0,0,
Cape Fear,1399,35000000,79091969,182291969,44091969,147291969,76.9160567313,19.3674704612,19.32097741,69,0,0,
The English Patient,1400,35000000,78651430,231651430,43651430,196651430,76.9160567313,19.5426894299,19.3191852384,13,0,0,
Guess Who,1401,35000000,67962333,101162333,32962333,66162333,76.9160567313,18.9894690498,19.2746860051,37,0,0,
This is 40,1402,35000000,67544505,90221182,32544505,55221182,76.9160567313,18.9255170113,19.2729057006,29,0,0,
L.A. Confidential,1403,35000000,64604977,110604977,29604977,75604977,76.9160567313,19.041554064,19.2602904029,11,0,0,
Sky High,1404,35000000,63939454,83109359,28939454,48109359,76.9160567313,18.8816411122,19.2574120097,24,0,0,
In & Out,1405,35000000,63826569,83226569,28826569,48226569,76.9160567313,18.8823800564,19.2569229582,37,0,0,
The Cell,1407,35000000,61280963,85911226,26280963,50911226,76.9160567313,18.8991575493,19.2458306419,74,0,0,
Species,1408,35000000,60000401,113300401,25000401,78300401,76.9160567313,19.0559373528,19.2402038113,13,0,0,
Secretariat,1409,35000000,59699513,60376247,24699513,25376247,76.9160567313,18.7268888131,19.2388770934,75,0,0,
The Benchwarmers,1410,35000000,57651794,62871766,22651794,27871766,76.9160567313,18.7450949164,19.2298009453,38,0,0,
The Man in the Iron Mask,1411,35000000,56876365,56876365,21876365,21876365,76.9160567313,18.7007837201,19.2263423767,4,0,0,
Friends with Benefits,1412,35000000,55802754,146595891,20802754,111595891,76.9160567313,19.2183957246,19.2215340247,72,0,0,
TMNT,1413,35000000,54149098,96096018,19149098,61096018,76.9160567313,18.9603635259,19.2140823116,29,0,0,
Radio,1414,35000000,52333738,53293628,17333738,18293628,76.9160567313,18.6733354848,19.2058374769,38,0,0,
Old Dogs,1415,35000000,49492060,95104304,14492060,60104304,76.9160567313,18.9545657215,19.1927933491,94,0,0,
Underworld 3: Rise of the Lycans,1417,35000000,45802315,89102315,10802315,54102315,76.9160567313,18.9187405726,19.175598412,36,0,0,
Malcolm X,1418,35000000,44707772,44707772,9707772,9707772,76.9160567313,18.604318218,19.1704402396,33,0,0,
Must Love Dogs,1419,35000000,43894863,58894863,8894863,23894863,76.9160567313,18.7159224578,19.1665920108,0,0,0,
License to Wed,1420,35000000,43799818,70187088,8799818,35187088,76.9160567313,18.7966300483,19.1661411089,71,0,0,
Donnie Brasco,1421,35000000,41954997,65303052,6954997,30303052,76.9160567313,18.762519228,19.1573486008,75,0,0,
Max Payne,1422,35000000,40687294,85761789,5687294,50761789,76.9160567313,18.8982310193,19.151261537,62,0,0,
The Ladykillers,1423,35000000,39692139,77392139,4692139,42392139,76.9160567313,18.8449177589,19.1464570571,8,0,0,
Resident Evil,1424,35000000,39532308,103200000,4532308,68200000,76.9160567313,19.0009404971,19.1456832577,55,0,0,
Something Borrowed,1425,35000000,39046489,65084116,4046489,30084116,76.9160567313,18.7609625578,19.1433275503,8,0,0,
The Nativity Story,1426,35000000,37629831,46309644,2629831,11309644,76.9160567313,18.6175615159,19.1364264045,88,0,0,
In Time,1427,35000000,37553932,165103952,2553932,130103952,76.9160567313,19.298455961,19.1360553205,4,0,0,
The Back-up Plan,1428,35000000,37490007,75281179,2490007,40281179,76.9160567313,18.8310101423,19.1357426727,35,0,0,
J. Edgar,1429,35000000,37306030,84606030,2306030,49606030,76.9160567313,18.8910360114,19.1348423223,86,0,0,
Bounce,1430,35000000,36805288,53425292,1805288,18425292,76.9160567313,18.6743576439,19.1323876671,81,0,0,
Hot Pursuit,1431,35000000,34580201,45680201,-419799,10680201,76.9160567313,18.6123785643,19.1214067426,28,0,0,
Closer,1432,35000000,33987757,115476509,-1012243,80476509,76.9160567313,19.0674004099,19.118462558,89,0,0,
Black Knight,1433,35000000,33422806,33422806,-1577194,-1577194,76.9160567313,18.5056930643,19.1156469042,68,0,0,
Street Fighter,1434,35000000,33210975,99210975,-1789025,64210975,76.9160567313,18.9783587528,19.1145891148,16,0,0,
The Bad News Bears,1435,35000000,32868349,33500620,-2131651,-1499380,76.9160567313,18.5064075313,19.1128758215,63,0,0,
The Pianist,1436,35000000,32519322,111854182,-2480678,76854182,76.9160567313,19.048245787,19.1111274967,18,0,0,
From Hell,1438,35000000,31598308,68712365,-3401692,33712365,76.9160567313,18.7864524358,19.1064992805,94,0,0,
Mirrors,1439,35000000,30691439,77220596,-4308561,42220596,76.9160567313,18.8437947762,19.1019211191,46,0,0,
Queen of the Damned,1440,35000000,30307804,30307804,-4692196,-4692196,76.9160567313,18.4766644582,19.0999780817,61,0,0,
Nanny McPhee and the Big Bang,1441,35000000,29011215,97613438,-5988785,62613438,76.9160567313,18.9691701773,19.0933830247,24,0,0,
Untraceable,1442,35000000,28687835,52649951,-6312165,17649951,76.9160567313,18.6683232736,19.0917313638,42,0,0,
Predator 2,1443,35000000,28317513,54768418,-6682487,19768418,76.9160567313,18.6847255955,19.0898365903,62,0,0,
Abduction,1444,35000000,28087155,86648359,-6912845,51648359,76.9160567313,18.9037153563,19.0886561367,60,0,0,
Flash Gordon,1445,35000000,27107960,27107960,-7892040,-7892040,76.9160567313,18.4459410199,19.0836227106,98,0,0,
Superhero Movie,1446,35000000,26638520,73026302,-8361480,38026302,76.9160567313,18.8159375509,19.0812006004,32,0,0,
Blast from the Past,1447,35000000,26494611,26494611,-8505389,-8505389,76.9160567313,18.4399425683,19.0804569149,0,0,0,
Alex Cross,1448,35000000,25888412,32785147,-9111588,-2214853,76.9160567313,18.4998189412,19.0773181451,53,0,0,
Jersey Girl,1449,35000000,25266129,37066129,-9733871,2066129,76.9160567313,18.5386092891,19.0740858155,24,0,0,
Midnight in the Garden of Good and Evil,1450,35000000,25078937,25078937,-9921063,-9921063,76.9160567313,18.4259585817,19.0731114349,93,0,0,
Ella Enchanted,1452,35000000,22913677,22913677,-12086323,-12086323,76.9160567313,18.4041846181,19.0617711704,97,0,0,
Hoffa,1453,35000000,22867875,27893490,-12132125,-7106510,76.9160567313,18.4535711941,19.061529894,29,0,0,
The X-Files: I Want to Believe,1454,35000000,20982478,68170792,-14017522,33170792,76.9160567313,18.7826886802,19.0515471142,62,0,0,
Premium Rush,1455,35000000,20275446,31393201,-14724554,-3606799,76.9160567313,18.4868751715,19.0477776854,60,0,0,
Broken City,1456,35000000,19701164,30746765,-15298836,-4253235,76.9160567313,18.4808064838,19.0447055,58,0,0,
Valiant,1457,35000000,19478106,64188387,-15521894,29188387,76.9160567313,18.7545684221,19.0435096769,24,0,0,
Wonder Boys,1458,35000000,19389454,33422485,-15610546,-1577515,76.9160567313,18.5056901159,19.0430340125,59,0,0,
Cursed,1459,35000000,19294901,25114901,-15705099,-9885099,76.9160567313,18.4263162646,19.0425264367,99,0,0,
Walk Hard: The Dewey Cox Story,1460,35000000,18317151,20606053,-16682849,-14393947,76.9160567313,18.3804449839,19.0372625539,10,0,0,
The Four Feathers,1461,35000000,18306166,29882645,-16693834,-5117355,76.9160567313,18.4726362456,19.0372032567,13,0,0,
Furry Vengeance,1462,35000000,17630465,39340177,-17369535,4340177,76.9160567313,18.5586185803,19.0335490298,68,0,0,
Parker,1463,35000000,17616641,48543388,-17383359,13543388,76.9160567313,18.6357407514,19.0334741293,81,0,0,
Wimbledon,1464,35000000,16862585,41666476,-18137415,6666476,76.9160567313,18.5786815853,19.0293800191,86,0,0,
Bait,1465,35000000,15325127,15471969,-19674873,-19528031,76.9160567313,18.3255148748,19.0209801745,70,0,0,
Dungeons and Dragons,1466,35000000,15185241,33771965,-19814759,-1228035,76.9160567313,18.5088949615,19.020212399,63,0,0,
Lions for Lambs,1467,35000000,14998070,63211088,-20001930,28211088,76.9160567313,18.7475450433,19.0191841732,17,0,0,
Flight of the Intruder,1468,35000000,14471440,14471440,-20528560,-20528560,76.9160567313,18.3144496496,19.0162854405,93,0,0,
The Tree of Life,1469,35000000,13305665,61721826,-21694335,26721826,76.9160567313,18.7367466666,19.0098386128,67,0,0,
American Outlaws,1470,35000000,13264986,13264986,-21735014,-21735014,76.9160567313,18.3009421125,19.0096129026,72,0,0,
Zoom,1471,35000000,11631245,12148105,-23368755,-22851895,76.9160567313,18.288272686,19.0005056088,29,0,0,
The Shipping News,1472,35000000,11405825,24405825,-23594175,-10594175,76.9160567313,18.4192403772,18.9992424675,0,0,0,
The Young Victoria,1473,35000000,11001272,31878891,-23998728,-3121109,76.9160567313,18.4914106806,18.9969715451,80,0,0,
Sabotage,1474,35000000,10508518,18376443,-24491482,-16623557,76.9160567313,18.3569598619,18.9941985298,98,0,0,
Whiteout,1475,35000000,10275638,12254746,-24724362,-22745254,76.9160567313,18.2894893316,18.992885297,88,0,0,
Unfinished Business,1476,35000000,10219501,12819501,-24780499,-22180499,76.9160567313,18.2959079456,18.9925684769,69,0,0,
The Fountain,1477,35000000,10144010,15461638,-24855990,-19538362,76.9160567313,18.3254012438,18.9921422705,7,0,0,
The Walk,1478,35000000,10137502,41913749,-24862498,6913749,76.9160567313,18.5807906978,18.9921055191,46,0,0,
Knock Off,1479,35000000,10076136,10076136,-24923864,-24923864,76.9160567313,18.2643354011,18.9917589128,6,0,0,
Mandela: Long Walk to Freedom,1480,35000000,8323085,27480015,-26676915,-7519985,76.9160567313,18.4495622004,18.9818062831,51,0,0,
Punisher: War Zone,1481,35000000,8050977,10157534,-26949023,-24842466,76.9160567313,18.2652866782,18.9802525195,89,0,0,
The Order,1482,35000000,7659747,11559747,-27340253,-23440253,76.9160567313,18.2815334862,18.9780143182,32,0,0,
A Good Year,1483,35000000,7459300,42064105,-27540700,7064105,76.9160567313,18.5820709863,18.9768656303,59,0,0,
Femme Fatale,1484,35000000,6592103,16792103,-28407897,-18207897,76.9160567313,18.3399298565,18.9718807844,36,0,0,
Warriors of Virtue,1485,35000000,6448817,6448817,-28551183,-28551183,76.9160567313,18.2209980593,18.9710547465,89,0,0,
Luther,1486,35000000,5781086,32738814,-29218914,-2261186,76.9160567313,18.4993907733,18.96719628,74,0,0,
Biutiful,1487,35000000,5101237,24687524,-29898763,-10312476,76.9160567313,18.4220574559,18.9632524345,54,0,0,
Radio Flyer,1488,35000000,4651977,4651977,-30348023,-30348023,76.9160567313,18.1988141147,18.9606376884,47,0,0,
Bound by Honor,1489,35000000,4496583,4496583,-30503417,-30503417,76.9160567313,18.1968722843,18.9597316833,51,0,0,
Smilla's Sense of Snow,1490,35000000,2221994,2221994,-32778006,-32778006,76.9160567313,18.1680084286,18.9463751673,23,0,0,
Playing for Keeps,1491,35000000,2000000,2000000,-33000000,-33000000,76.9160567313,18.1651462495,18.9450619996,38,0,0,
Lion of the Desert,1492,35000000,1500000,1500000,-33500000,-33500000,76.9160567313,18.1586695633,18.9420980038,64,0,0,
Le hussard sur le toit,1493,35000000,1286429,1286429,-33713571,-33713571,76.9160567313,18.1558902617,18.9408292741,75,0,0,
Ride With the Devil,1494,35000000,630779,630779,-34369221,-34369221,76.9160567313,18.1473093963,18.9369242644,5,0,0,
The Darkest Hour,1498,34800000,21443494,62831715,-13356506,28031715,76.805940405,18.7462506008,19.0550584107,82,0,0,
The Maze Runner,1499,34000000,102427862,345527862,68427862,311527862,76.3606698166,19.8604639844,19.4152989275,62,0,0,
The Longest Ride,1500,34000000,37446117,61146117,3446117,27146117,76.3606698166,18.7398350224,19.1404086949,32,0,0,
The Age of Innocence,1501,34000000,32014993,32014993,-1985007,-1985007,76.3606698166,18.5019402649,19.1136094707,62,0,0,
Gake no ue no Ponyo,1502,34000000,15090399,205312666,-18909601,171312666,76.3606698166,19.4565765235,19.0251700292,0,0,0,
Chill Factor,1503,34000000,11263966,11263966,-22736034,-22736034,76.3606698166,18.2895944512,19.0040425615,96,0,0,
The Astronaut's Wife,1504,34000000,10672566,10672566,-23327434,-23327434,76.3606698166,18.2828292676,19.0007369782,14,0,0,
I Dreamed of Africa,1505,34000000,6543194,6543194,-27456806,-27456806,76.3606698166,18.2342720784,18.9773465565,88,0,0,
Thunder and the House of Magic,1506,34000000,4091,10124184,-33995909,-23875816,76.3606698166,18.2765150183,18.9391495561,12,0,0,
Reds,1507,33500000,50000000,50000000,16500000,16500000,76.078370457,18.6593057725,19.2020279827,34,0,0,
A Few Good Men,1508,33000000,140525790,235685612,107525790,202685612,75.7928931137,19.5621476927,19.5503623795,83,0,0,
Big Momma's House,1509,33000000,117559438,173559438,84559438,140559438,75.7928931137,19.3410020621,19.4732517434,82,0,0,
Exit Wounds,1510,33000000,51758599,79958599,18758599,46958599,75.7928931137,18.8743570614,19.2123145088,67,0,0,
Step Up Revolution,1511,33000000,35074677,165552290,2074677,132552290,75.7928931137,19.308582421,19.1337089704,51,0,0,
Snakes on a Plane,1512,33000000,34020814,62020814,1020814,29020814,75.7928931137,18.7533676539,19.1285299926,50,0,0,
The Punisher,1513,33000000,33571379,54440783,571379,21440783,75.7928931137,18.6974865715,19.1263131586,1,0,0,
The Watcher,1514,33000000,28946615,47267829,-4053385,14267829,75.7928931137,18.641566316,19.1032114487,90,0,0,
Safe,1515,33000000,17142080,41495213,-15857920,8495213,75.7928931137,18.5941755847,19.0417055237,16,0,0,
Doomsday,1516,33000000,11008770,21621188,-21991230,-11378812,75.7928931137,18.4113516632,19.0081900982,80,0,0,
Pushing Tin,1517,33000000,8408835,8408835,-24591165,-24591165,75.7928931137,18.2682178708,18.9936366189,53,0,0,
Goal! The Dream Begins,1518,33000000,4283255,27610873,-28716745,-5389127,75.7928931137,18.4700527865,18.9700994378,24,0,0,
The Young and Prodigious T.S. Spivet,1519,33000000,176847,357687,-32823153,-32642313,75.7928931137,18.1697538993,18.9461082475,32,0,0,
Star Wars Ep. VI: Return of the Jedi,1521,32500000,309125409,572625409,276625409,540125409,75.5041530348,20.2933681459,19.9863062158,49,0,0,
Bridesmaids,1522,32500000,169106725,289527030,136606725,257027030,75.5041530348,19.7221720298,19.6401765782,41,0,0,
The Reader,1523,32500000,34194407,113019290,1694407,80519290,75.5041530348,19.067624455,19.1318433086,59,0,0,
The Big Wedding,1524,32500000,21819348,48425971,-10680652,15925971,75.5041530348,18.6547738338,19.0691478148,30,0,0,
Wanderlust,1525,32500000,17288155,24159934,-15211845,-8340066,75.5041530348,18.4415629453,19.0451714751,72,0,0,
Elf,1526,32000000,173398518,220236410,141398518,188236410,75.2120618617,19.5149055952,19.6542312989,75,0,0,
Phenomenon,1527,32000000,104632573,152032573,72632573,120032573,75.2120618617,19.2556868624,19.4307309776,27,0,0,
This is the End,1528,32000000,101470202,126539117,69470202,94539117,75.2120618617,19.1384686285,19.4191467621,13,0,0,
Snow Dogs,1529,32000000,81150692,116898028,49150692,84898028,75.2120618617,19.0902945236,19.3413300156,68,0,0,
Nacho Libre,1530,32000000,80197993,99296462,48197993,67296462,75.2120618617,18.9958700836,19.3375285767,71,0,0,
Scrooged,1531,32000000,59450353,59450353,27450353,27450353,75.2120618617,18.7420436575,19.2509414674,5,0,0,
Takers,1532,32000000,57744720,70587268,25744720,38587268,75.2120618617,18.8197085773,19.2434782249,25,0,0,
Source Code,1533,32000000,54712227,140428499,22712227,108428499,75.2120618617,19.2040284404,19.2300699869,0,0,0,
Stigmata,1534,32000000,50041732,89441732,18041732,57441732,75.2120618617,18.9388313187,19.2090610696,86,0,0,
Men of Honor,1535,32000000,48814909,82339483,16814909,50339483,75.2120618617,18.8956080135,19.2034685628,19,0,0,
The Transporter 2,1536,32000000,43095600,88978202,11095600,56978202,75.2120618617,18.936066618,19.1769760467,70,0,0,
"Big Mommas: Like Father, Like Son",1537,32000000,37915414,82332450,5915414,50332450,75.2120618617,18.8955642722,19.1523596264,40,0,0,
The Number 23,1538,32000000,35193167,77593167,3193167,45593167,75.2120618617,18.8656447894,19.1391763611,34,0,0,
Alive,1539,32000000,34327309,34327309,2327309,2327309,75.2120618617,18.5409278614,19.1349464993,5,0,0,
1941,1540,32000000,34175000,94875000,2175000,62875000,75.2120618617,18.9706803991,19.1342005903,65,0,0,
Dreamer: Inspired by a True Story,1541,32000000,33022286,39498360,1022286,7498360,75.2120618617,18.5857595114,19.1285372451,37,0,0,
A History of Violence,1542,32000000,31493782,61477797,-506218,29477797,75.2120618617,18.7566388414,19.120977818,31,0,0,
The Incredible Burt Wonderstone,1543,32000000,22537881,24255957,-9462119,-7744043,75.2120618617,18.4473830334,19.0754986643,94,0,0,
The Quick and the Dead,1544,32000000,18543650,18543650,-13456350,-13456350,75.2120618617,18.3901585655,19.0545288323,8,0,0,
Laws of Attraction,1545,32000000,17848322,29948322,-14151678,-2051678,75.2120618617,18.5013253997,19.0508329742,55,0,0,
Going the Distance,1546,32000000,17804299,43603990,-14195701,11603990,75.2120618617,18.6199760286,19.0505985195,28,0,0,
Bringing Out The Dead,1547,32000000,16640210,16640210,-15359790,-15359790,75.2120618617,18.370339123,19.0443788651,66,0,0,
Repo Men,1548,32000000,13794835,18048066,-18205165,-13951934,75.2120618617,18.3850360326,19.0290113518,38,0,0,
D-War,1549,32000000,10977721,79915361,-21022279,47915361,75.2120618617,18.880416861,19.0135602075,58,0,0,
Bogus,1550,32000000,4340826,4340826,-27659174,-27659174,75.2120618617,18.2318307393,18.9761860785,38,0,0,
Cats Don't Dance,1551,32000000,3562749,3562749,-28437251,-28437251,75.2120618617,18.2223882196,18.9717116153,48,0,0,
Cradle Will Rock,1552,32000000,2899970,2899970,-29100030,-29100030,75.2120618617,18.2142739978,18.9678843384,83,0,0,
The Good German,1553,32000000,1308696,1308696,-30691304,-30691304,75.2120618617,18.1945193687,18.9586351344,20,0,0,
Apocalypse Now,1555,31500000,78800000,81250488,47300000,49750488,74.9165274166,18.8919381495,19.3339321458,56,0,0,
Flight,1556,31000000,93772375,159584158,62772375,128584158,74.6174534732,19.2921180326,19.3941594075,25,0,0,
Out of Africa,1557,31000000,79096868,258210860,48096868,227210860,74.6174534732,19.6375532937,19.3371242202,0,0,0,
Moonraker,1558,31000000,70300000,210300000,39300000,179300000,74.6174534732,19.4845298754,19.3013083224,66,0,0,
The Grand Budapest Hotel,1559,31000000,59076019,164350409,28076019,133350409,74.6174534732,19.3118614453,19.2536652554,1,0,0,
Vacation,1560,31000000,58884188,100655793,27884188,69655793,74.6174534732,19.0090563188,19.2528309225,43,0,0,
Arachnophobia,1561,31000000,53208180,53208180,22208180,22208180,74.6174534732,18.703288127,19.2278238024,82,0,0,
Frequency,1562,31000000,44983704,68079671,13983704,37079671,74.6174534732,18.8095415133,19.190441799,34,0,0,
Hearts in Atlantis,1563,31000000,24185781,30885781,-6814219,-114219,74.6174534732,18.5190410221,19.0891617094,1,0,0,
Extraordinary Measures,1564,31000000,12482741,15826984,-18517259,-15173016,74.6174534732,18.3723013685,19.0273113088,93,0,0,
Get Shorty,1565,30250000,71752669,114752669,41502669,84502669,74.161984871,19.0882686054,19.3103974535,72,0,0,
Ghostbusters,1566,30000000,242212467,295212467,212212467,265212467,74.0082804492,19.7442022483,19.8417479314,64,0,0,
Toy Story,1567,30000000,191652928,364402211,161652928,334402211,74.0082804492,19.9132532189,19.7115491033,43,0,0,
Chicago,1568,30000000,170687518,307687518,140687518,277687518,74.0082804492,19.7768708861,19.6521583172,88,0,0,
Big Daddy,1569,30000000,163479795,228641283,133479795,198641283,74.0082804492,19.5491479884,19.6308973631,74,0,0,
American Pie 2,1570,30000000,145096820,286500000,115096820,256500000,74.0082804492,19.7207368165,19.5745326432,49,0,0,
The Vow,1571,30000000,125014030,197618160,95014030,167618160,74.0082804492,19.4433776918,19.5090923522,84,0,0,
Speed,1572,30000000,120360822,282312677,90360822,252312677,74.0082804492,19.7092600632,19.4932985616,10,0,0,
Lee Daniels' The Butler,1573,30000000,116632095,177025498,86632095,147025498,74.0082804492,19.3664360601,19.4804600864,14,0,0,
Remember the Titans,1574,30000000,115654751,136706683,85654751,106706683,74.0082804492,19.1961308069,19.4770675259,33,0,0,
District 9,1575,30000000,115646235,212453431,85646235,182453431,74.0082804492,19.4953543519,19.4770379145,83,0,0,
Dodgeball: A True Underdog Story,1576,30000000,114326736,167791704,84326736,137791704,74.0082804492,19.3299144173,19.4724391921,56,0,0,
The Addams Family,1577,30000000,113502246,191502246,83502246,161502246,74.0082804492,19.4211379326,19.4695549038,33,0,0,
The Hunt for Red October,1578,30000000,113485385,193275519,83485385,163275519,74.0082804492,19.4276372909,19.4694958326,7,0,0,
Ace Ventura: When Nature Calls,1579,30000000,108344348,212384285,78344348,182384285,74.0082804492,19.4951182532,19.4513198875,11,0,0,
The Princess Diaries,1580,30000000,108244774,165334774,78244774,135334774,74.0082804492,19.3199677931,19.4509645654,82,0,0,
Analyze This,1581,30000000,106823373,176823373,76823373,146823373,74.0082804492,19.3656507264,19.4458785933,63,0,0,
The First Wives Club,1582,30000000,105444419,181444419,75444419,151444419,74.0082804492,19.3834529237,19.4409196586,96,0,0,
Million Dollar Baby,1583,30000000,100422786,231946985,70422786,201946985,74.0082804492,19.5597860995,19.4226503578,78,0,0,
Se7en,1584,30000000,100058010,328058010,70058010,298058010,74.0082804492,19.8280226728,19.4213101647,44,0,0,
Mystic River,1585,30000000,90135191,156822020,60135191,126822020,74.0082804492,19.2847188246,19.3841470497,43,0,0,
Pokemon: The First Movie,1586,30000000,85744662,163644662,55744662,133644662,74.0082804492,19.3130676585,19.3672522815,6,0,0,
SpongeBob SquarePants: The Movie,1587,30000000,85416609,142051255,55416609,112051255,74.0082804492,19.2204443877,19.3659783977,57,0,0,
Up in the Air,1588,30000000,83823381,166842739,53823381,136842739,74.0082804492,19.3260843496,19.359768447,17,0,0,
The Notebook,1589,30000000,81001787,116117340,51001787,86117340,74.0082804492,19.0965168589,19.3486751519,82,0,0,
Hannah Montana the Movie,1590,30000000,79559647,169156664,49559647,139156664,74.0082804492,19.3353978624,19.3429573964,28,0,0,
27 Dresses,1591,30000000,76806312,160245463,46806312,130245463,74.0082804492,19.2990440588,19.3319494184,41,0,0,
Rugrats in Paris,1592,30000000,76501438,103284813,46501438,73284813,74.0082804492,19.0290053595,19.3307230309,27,0,0,
The Prince of Tides,1593,30000000,74787599,74787599,44787599,44787599,74.0082804492,18.8604689569,19.3238008021,100,0,0,
Four Brothers,1594,30000000,74494381,92494381,44494381,62494381,74.0082804492,18.968482003,19.3226116736,51,0,0,
Looper,1595,30000000,66486205,170466405,36486205,140466405,74.0082804492,19.3406313583,19.2895759479,23,0,0,
Legends of the Fall,1596,30000000,66484854,160484854,36484854,130484854,74.0082804492,19.300038144,19.2895702816,94,0,0,
Warm Bodies,1597,30000000,66380662,115121608,36380662,85121608,74.0082804492,19.0914383891,19.2891331871,87,0,0,
About Schmidt,1598,30000000,65005217,107054484,35005217,77054484,74.0082804492,19.0493146084,19.2833450956,100,0,0,
The Nut Job,1599,30000000,64251538,122529966,34251538,92529966,74.0082804492,19.1286190348,19.2801592285,99,0,0,
Down to Earth,1600,30000000,64172251,71172251,34172251,41172251,74.0082804492,18.8369043909,19.2798234846,97,0,0,
Babe,1601,30000000,63634380,246075470,33634380,216075470,74.0082804492,19.604019254,19.2775428678,55,0,0,
Hope Springs,1602,30000000,63536011,115849781,33536011,85849781,74.0082804492,19.0951547765,19.2771252121,60,0,0,
Forgetting Sarah Marshall,1603,30000000,62932375,104932954,32932375,74932954,74.0082804492,19.0379355706,19.2745584638,58,0,0,
Friday Night Lights,1604,30000000,61188085,61882934,31188085,31882934,74.0082804492,18.7736811772,19.267104248,70,0,0,
Baby Mama,1605,30000000,60321790,63998025,30321790,33998025,74.0082804492,18.7884319876,19.2633813862,54,0,0,
Hope Floats,1606,30000000,60033780,81452467,30033780,51452467,74.0082804492,18.9025061511,19.2621406006,23,0,0,
Bride Wars,1607,30000000,58715510,115150424,28715510,85150424,74.0082804492,19.0915857205,19.2564415839,59,0,0,
Without a Paddle,1608,30000000,58156435,65121280,28156435,35121280,74.0082804492,18.796178084,19.2540148027,82,0,0,
13 Going On 30,1609,30000000,57139723,96439723,27139723,66439723,74.0082804492,18.9910384306,19.2495864029,60,0,0,
Midnight in Paris,1610,30000000,56816662,162942835,26816662,132942835,74.0082804492,19.3101882953,19.2481751599,75,0,0,
Wallace & Gromit: The Curse of the Were-Rabbit,1611,30000000,56068547,197593152,26068547,167593152,74.0082804492,19.443287753,19.2448994667,35,0,0,
P.S. I Love You,1612,30000000,53695808,155769678,23695808,125769678,74.0082804492,19.2802737935,19.234438643,45,0,0,
The Corpse Bride,1613,30000000,53359111,114770654,23359111,84770654,74.0082804492,19.0896422754,19.2329453229,94,0,0,
Letters to Juliet,1614,30000000,53032453,82148538,23032453,52148538,74.0082804492,18.906796252,19.2314943934,27,0,0,
Blow,1615,30000000,52990775,83282296,22990775,53282296,74.0082804492,18.9137447887,19.2313091191,24,0,0,
Message in a Bottle,1616,30000000,52799004,52799004,22799004,22799004,74.0082804492,18.7077319625,19.2304561826,86,0,0,
Southpaw,1617,30000000,52421953,87982196,22421953,57982196,74.0082804492,18.942045266,19.2287770552,72,0,0,
Like Mike,1618,30000000,51432423,62432423,21432423,32432423,74.0082804492,18.777534327,19.2243569086,9,0,0,
Atonement,1619,30000000,50980159,129779728,20980159,99779728,74.0082804492,19.1637125848,19.2223301598,80,0,0,
Naked Gun 33 1/3: The Final Insult,1620,30000000,50825302,50825302,20825302,20825302,74.0082804492,18.6928090615,19.2216352478,56,0,0,
Star Trek V: The Final Frontier,1621,30000000,50531965,68521916,20531965,38521916,74.0082804492,18.8192699875,19.2203175895,92,0,0,
A View to a Kill,1622,30000000,49667091,151967091,19667091,121967091,74.0082804492,19.2640451628,19.2164224725,13,0,0,
Racing Stripes,1623,30000000,49186871,89369889,19186871,59369889,74.0082804492,18.950250382,19.2142531457,14,0,0,
Sicario,1624,30000000,46106164,75893798,16106164,45893798,74.0082804492,18.8675695216,19.2002234182,68,0,0,
The Three Stooges,1625,30000000,44338224,53801644,14338224,23801644,74.0082804492,18.7152283397,19.1920823188,80,0,0,
Pokemon 2000,1626,30000000,43746923,133946923,13746923,103946923,74.0082804492,19.1833407642,19.1893446083,14,0,0,
Black Rain,1627,30000000,43140147,43140147,13140147,13140147,74.0082804492,18.6324833411,19.1865274353,43,0,0,
Glory Road,1628,30000000,42647449,42799060,12647449,12799060,74.0082804492,18.6297197077,19.1842340569,49,0,0,
The Age of Adaline,1629,30000000,42629776,60333540,12629776,30333540,74.0082804492,18.7627358105,19.184151696,9,0,0,
Step Up 3D,1630,30000000,42400223,165889117,12400223,135889117,74.0082804492,19.3222206514,19.1830813008,3,0,0,
Drag Me To Hell,1631,30000000,42100625,91388487,12100625,61388487,74.0082804492,18.9620669729,19.1816825632,61,0,0,
The Cabin in the Woods,1632,30000000,42073277,70768144,12073277,40768144,74.0082804492,18.8342356149,19.1815547857,84,0,0,
Secondhand Lions,1633,30000000,42023715,47855342,12023715,17855342,74.0082804492,18.6699253517,19.1813231765,66,0,0,
Stranger Than Fiction,1634,30000000,40435190,53572822,10435190,23572822,74.0082804492,18.7135224626,19.1738712528,52,0,0,
Hanna,1635,30000000,40259119,65343694,10259119,35343694,74.0082804492,18.7977047855,19.1730418577,8,0,0,
Blue Crush,1636,30000000,40118420,51618420,10118420,21618420,74.0082804492,18.6988325121,19.1723785902,34,0,0,
30 Days of Night,1637,30000000,39568996,80276156,9568996,50276156,74.0082804492,18.8952140861,19.1697843355,6,0,0,
Little Shop of Horrors,1638,30000000,38747385,38747385,8747385,8747385,74.0082804492,18.5962934048,19.1658922751,3,0,0,
Gridiron Gang,1639,30000000,38432823,41457834,8432823,11457834,74.0082804492,18.6187778434,19.1643981416,53,0,0,
Midnight Run,1640,30000000,38413606,81613606,8413606,51613606,74.0082804492,18.9035009391,19.1643067906,43,0,0,
Meet the Spartans,1641,30000000,38233676,84646831,8233676,54646831,74.0082804492,18.9220441801,19.1634510608,73,0,0,
The Running Man,1642,30000000,37743350,37743350,7743350,7743350,74.0082804492,18.5878344484,19.1611153936,99,0,0,
The Family,1643,30000000,36918811,51078541,6918811,21078541,74.0082804492,18.6947362678,19.1571753611,100,0,0,
Mortal Kombat: Annihilation,1644,30000000,35927406,51327406,5927406,21327406,74.0082804492,18.6966265754,19.1524173183,16,0,0,
Larry Crowne,1645,30000000,35608245,61449135,5608245,31449135,74.0082804492,18.7706287518,19.1508807414,40,0,0,
Take the Lead,1647,30000000,34742066,65390493,4742066,35390493,74.0082804492,18.7980257282,19.1466986489,13,0,0,
Love and Other Drugs,1648,30000000,32367005,102719647,2367005,72719647,74.0082804492,19.0259246354,19.1351408128,65,0,0,
Entourage,1649,30000000,32363404,46225326,2363404,16225326,74.0082804492,18.6571397933,19.1351231873,26,0,0,
What's the Worst That Could Happen?,1650,30000000,32267774,38462071,2267774,8462071,74.0082804492,18.593896914,19.1346550024,47,0,0,
9,1652,30000000,31749894,48559999,1749894,18559999,74.0082804492,18.6754023468,19.1321157532,53,0,0,
Deliver Us from Evil,1653,30000000,30577122,87956618,577122,57956618,74.0082804492,18.9418933953,19.126341517,28,0,0,
Get on Up,1654,30000000,30569935,33315804,569935,3315804,74.0082804492,18.5496546697,19.1263060282,84,0,0,
The Five-Year Engagement,1655,30000000,28700285,54732938,-1299715,24732938,74.0082804492,18.7221413056,19.1170308198,76,0,0,
The Prince & Me,1656,30000000,28165882,29356757,-1834118,-643243,74.0082804492,18.5142348283,19.114363796,82,0,0,
Winnie the Pooh,1657,30000000,26692846,50145607,-3307154,20145607,74.0082804492,18.6876179903,19.1069753341,5,0,0,
Bulworth,1658,30000000,26525834,29200533,-3474166,-799467,74.0082804492,18.5128111008,19.1061341785,19,0,0,
Dumb and Dumberer: When Harry Met Lloyd,1659,30000000,26214846,26214846,-3785154,-3785154,74.0082804492,18.4852044651,19.1045660001,73,0,0,
Virtuosity,1660,30000000,23980766,23980766,-6019234,-6019234,74.0082804492,18.4640372009,19.0932276229,68,0,0,
One True Thing,1661,30000000,23209440,26580440,-6790560,-3419560,74.0082804492,18.4886260991,19.0892829512,20,0,0,
Sanctum,1662,30000000,23209310,104283753,-6790690,74283753,74.0082804492,19.0344274835,19.089282285,50,0,0,
My Super Ex-Girlfriend,1663,30000000,22530295,60772856,-7469705,30772856,74.0082804492,18.7658514533,19.0857967773,99,0,0,
Mr. 3000,1664,30000000,21800302,21827296,-8199698,-8172704,74.0082804492,18.443200637,19.0820359892,71,0,0,
The Next Three Days,1665,30000000,21148651,67255916,-8851349,37255916,74.0082804492,18.8107354393,19.0786668145,67,0,0,
Little Black Book,1666,30000000,20422207,21758371,-9577793,-8241629,74.0082804492,18.4425265082,19.0748975149,8,0,0,
Assault On Precinct 13,1667,30000000,20040895,36040895,-9959105,6040895,74.0082804492,18.5733257509,19.0729133008,83,0,0,
Runner Runner,1668,30000000,19316646,62616646,-10683354,32616646,74.0082804492,18.7788228272,19.0691336874,94,0,0,
The Replacement Killers,1669,30000000,18967571,18967571,-11032429,-11032429,74.0082804492,18.4148418609,19.067306867,18,0,0,
Ultraviolet,1670,30000000,18522064,30962112,-11477936,962112,74.0082804492,18.5287487771,19.0649705294,46,0,0,
North Country,1671,30000000,18324242,23676771,-11675758,-6323229,74.0082804492,18.4611219909,19.0639313543,75,0,0,
Fright Night,1672,30000000,18298649,40520649,-11701351,10520649,74.0082804492,18.6110605045,19.0637968333,0,0,0,
Eight Legged Freaks,1673,30000000,17266505,36722311,-12733495,6722311,74.0082804492,18.5791582183,19.0583565774,9,0,0,
Fled,1674,30000000,17192205,19892205,-12807795,-10107795,74.0082804492,18.4240993639,19.0579638104,64,0,0,
Splice,1675,30000000,17010170,26857459,-12989830,-3142541,74.0082804492,18.4912109759,19.0570008788,28,0,0,
88 Minutes,1676,30000000,16930884,32955399,-13069116,2955399,74.0082804492,18.5464816924,19.0565811804,82,0,0,
The Whole Ten Yards,1677,30000000,16323969,26323969,-13676031,-3676031,74.0082804492,18.4862269854,19.0533626432,35,0,0,
Howard the Duck,1678,30000000,16295774,16295774,-13704226,-13704226,74.0082804492,18.3875997108,19.0532128699,67,0,0,
Pride and Glory,1679,30000000,15740721,43440721,-14259279,13440721,74.0082804492,18.6349124062,19.0502598231,24,0,0,
The Cave,1680,30000000,14888028,27028028,-15111972,-2971972,74.0082804492,18.4927992457,19.045706186,64,0,0,
Godsend,1681,30000000,14334645,16910708,-15665355,-13089292,74.0082804492,18.3939357643,19.0427398203,68,0,0,
Alex & Emma,1682,30000000,14208384,15358583,-15791616,-14641417,74.0082804492,18.3778653578,19.0420617736,35,0,0,
Wicker Park,1683,30000000,13001257,21601257,-16998743,-8398743,74.0082804492,18.4409881361,19.0355559457,69,0,0,
The New World,1684,30000000,12712093,26184400,-17287907,-3815600,74.0082804492,18.4849189889,19.0339911882,72,0,0,
The Last Stand,1685,30000000,12050299,48330757,-17949701,18330757,74.0082804492,18.6736238375,19.0304007711,37,0,0,
In Dreams,1686,30000000,11927682,11927682,-18072318,-18072318,74.0082804492,18.3413985904,19.0297341219,87,0,0,
Wing Commander,1687,30000000,11578022,11578022,-18421978,-18421978,74.0082804492,18.3376063053,19.0278306314,60,0,0,
Antitrust,1688,30000000,10965209,17865209,-19034791,-12134791,74.0082804492,18.403691755,19.0244858153,94,0,0,
Dead Man Down,1689,30000000,10895295,18903193,-19104705,-11096807,74.0082804492,18.4141941012,19.0241035033,85,0,0,
Hoodwinked Too: Hood vs. Evil,1690,30000000,10143779,23353111,-19856221,-6646889,74.0082804492,18.4580088308,19.0199847182,79,0,0,
Dragonball Evolution,1691,30000000,9362785,58228460,-20637215,28228460,74.0082804492,18.7476703191,19.0156863231,20,0,0,
First Daughter,1692,30000000,9055010,10419084,-20944990,-19580916,74.0082804492,18.3249330546,19.0139873184,33,0,0,
An Unfinished Life,1693,30000000,8535575,18535575,-21464425,-11464425,74.0082804492,18.4104871353,19.0111133276,40,0,0,
The Imaginarium of Doctor Parnassus,1694,30000000,7689607,64352607,-22310393,34352607,74.0082804492,18.7908837132,19.006414904,90,0,0,
Barney's Version,1695,30000000,7502560,8845575,-22497440,-21154425,74.0082804492,18.3074652028,19.0053730764,39,0,0,
Trapped,1696,30000000,6916869,6916869,-23083131,-23083131,74.0082804492,18.2856294656,19.0021038152,93,0,0,
Once Upon a Time in America,1697,30000000,5321508,5321508,-24678492,-24678492,74.0082804492,18.2672002563,18.9931440988,15,0,0,
Gloria,1698,30000000,4167493,4967493,-25832507,-25032507,74.0082804492,18.2630643071,18.9866126234,87,0,0,
The Assassination of Jesse James by the Coward Robert Ford,1699,30000000,3909149,15313631,-26090851,-14686369,74.0082804492,18.3773960634,18.9851445897,1,0,0,
The Merchant of Venice,1700,30000000,3765585,18765585,-26234415,-11234415,74.0082804492,18.412808106,18.9843278581,50,0,0,
The Good Thief,1701,30000000,3517797,6460758,-26482203,-23539242,74.0082804492,18.2803951646,18.9829166279,38,0,0,
Supercross,1702,30000000,3102550,3252550,-26897450,-26747450,74.0082804492,18.2427828923,18.980547192,0,0,0,
Miss Potter,1703,30000000,2975649,35861301,-27024351,5861301,74.0082804492,18.5717828646,18.9798219622,28,0,0,
Wu ji,1704,30000000,669625,35869934,-29330375,5869934,74.0082804492,18.5718570849,18.966550753,99,0,0,
Machine Gun Preacher,1705,30000000,538690,3721988,-29461310,-26278012,74.0082804492,18.248375615,18.9657919095,28,0,0,
DOA: Dead or Alive,1706,30000000,480314,7755686,-29519686,-22244314,74.0082804492,18.2951847297,18.9654534014,22,0,0,
Le Petit Nicolas,1707,30000000,201857,52339566,-29798143,22339566,74.0082804492,18.7042780451,18.9638371188,29,0,0,
Xinhai geming,1708,30000000,135739,8593154,-29864261,-21406846,74.0082804492,18.3046344045,18.9634529578,74,0,0,
Wild Card,1709,30000000,3200,929157,-29996800,-29070843,74.0082804492,18.2146327155,18.9626824305,80,0,0,
United Passions,1710,30000000,918,158918,-29999082,-29841082,74.0082804492,18.2051228488,18.9626691587,16,0,0,
Pitch Perfect 2,1716,29000000,183785415,286654563,154785415,257654563,73.3836821585,19.7238782518,19.6924806013,2,0,0,
Walk the Line,1717,29000000,119519402,187707495,90519402,158707495,73.3836821585,19.4108081486,19.4938409353,87,0,0,
Twelve Monkeys,1718,29000000,57097229,168797229,28097229,139797229,73.3836821585,19.3379608703,19.2537574616,31,0,0,
Once Upon a Time in Mexico,1719,29000000,56330657,97413527,27330657,68413527,73.3836821585,19.0021350071,19.2504195337,65,0,0,
Keeping the Faith,1720,29000000,37036404,45336404,8036404,16336404,73.3836821585,18.658016279,19.1625120117,25,0,0,
The Borrowers,1721,29000000,22359293,53785536,-6640707,24785536,73.3836821585,18.7225303168,19.0900505398,53,0,0,
Frost/Nixon,1722,29000000,18622031,28452945,-10377969,-547055,73.3836821585,18.5151104181,19.0707291318,25,0,0,
Seed of Chucky,1723,29000000,17016190,24716190,-11983810,-4283810,73.3836821585,18.480518534,19.0623109789,19,0,0,
Serving Sara,1724,29000000,16930185,20146150,-12069815,-8853850,73.3836821585,18.4365185808,19.0618581172,96,0,0,
Confessions of a Dangerous Mind,1725,29000000,16003576,33009663,-12996424,4009663,73.3836821585,18.555735145,19.0569659803,27,0,0,
Taking Woodstock,1726,29000000,7460204,10066366,-21539796,-18933634,73.3836821585,18.3320310221,19.010695619,44,0,0,
Cry Freedom,1727,29000000,5899797,25899797,-23100203,-3100203,73.3836821585,18.4916054457,19.0020083608,9,0,0,
Mumford,1728,28700000,4559569,4559569,-24140431,-24140431,73.1931560625,18.2734538345,18.9961748867,41,0,0,
The Jacket,1729,28500000,6301131,15452978,-22198869,-13047022,73.065307267,18.3943698277,19.0070355621,77,0,0,
Aladdin,1730,28000000,208577270,495277270,180577270,467277270,72.7427152513,20.174612883,19.762287814,1,0,0,
Indiana Jones and the Temple of Doom,1731,28000000,175083524,328283524,147083524,300283524,72.7427152513,19.8334557913,19.6706536668,6,0,0,
Straight Outta Compton,1732,28000000,161058685,200446771,133058685,172446771,72.7427152513,19.4605934778,19.6296411077,2,0,0,
The Rugrats Movie,1733,28000000,100491683,140891683,72491683,112891683,72.7427152513,19.2242144511,19.4302177236,33,0,0,
Die Hard,1734,28000000,80639179,138398283,52639179,110398283,72.7427152513,19.2129876173,19.3551276505,4,0,0,
Along Came a Spider,1735,28000000,74058698,105159085,46058698,77159085,72.7427152513,19.0498723108,19.3289393808,68,0,0,
Safe Haven,1736,28000000,71399120,94050951,43399120,66050951,72.7427152513,18.9888381936,19.3181573591,53,0,0,
Role Models,1737,28000000,67294270,94494141,39294270,66494141,72.7427152513,18.9913460209,19.30128457,84,0,0,
"Alexander and the Terrible, Horrible, No Good, Very Bad Day",1738,28000000,66954149,86254149,38954149,58254149,72.7427152513,18.9436585757,19.299873663,47,0,0,
Miracle,1739,28000000,64378093,64474705,36378093,36474705,72.7427152513,18.8054324498,19.2891224075,27,0,0,
Last Vegas,1740,28000000,63914167,112914167,35914167,84914167,72.7427152513,19.0903771367,19.287173854,49,0,0,
The Wedding Planner,1741,28000000,60400856,94728529,32400856,66728529,72.7427152513,18.9926697865,19.2722929001,46,0,0,
For Your Eyes Only,1743,28000000,54800000,195300000,26800000,167300000,72.7427152513,19.4422328578,19.2481023205,84,0,0,
The Royal Tenenbaums,1744,28000000,52353636,71430876,24353636,43430876,72.7427152513,18.8516909013,19.2373498258,0,0,0,
Identity,1745,28000000,52131264,82183683,24131264,54183683,72.7427152513,18.9192349307,19.2363666783,31,0,0,
Serendipity,1746,28000000,50255310,75294136,22255310,47294136,72.7427152513,18.8764864201,19.2280340418,25,0,0,
Kick-Ass,1747,28000000,48071303,97531134,20071303,69531134,72.7427152513,19.0083639369,19.2182448031,34,0,0,
Zoolander,1748,28000000,45172250,60780981,17172250,32780981,72.7427152513,18.7799708265,19.2051007424,32,0,0,
Timecop,1749,28000000,44327925,101527925,16327925,73527925,72.7427152513,19.030327651,19.2012399321,83,0,0,
No Reservations,1750,28000000,43107979,91943956,15107979,63943956,72.7427152513,18.9768288006,19.1956350747,9,0,0,
Hocus Pocus,1751,28000000,39360491,39360491,11360491,11360491,72.7427152513,18.6179790293,19.1782186785,10,0,0,
Pride & Prejudice,1752,28000000,38372662,126549607,10372662,98549607,72.7427152513,19.1578440875,19.1735767889,64,0,0,
30 Minutes or Less,1753,28000000,37053924,40966716,9053924,12966716,72.7427152513,18.6310790831,19.1673461557,71,0,0,
Dracula 2000,1754,28000000,33000377,33000377,5000377,5000377,72.7427152513,18.5643534555,19.1479476594,26,0,0,
Blade Runner,1755,28000000,32656328,33139618,4656328,5139618,72.7427152513,18.5655587942,19.1462837352,1,0,0,
Rob Roy,1756,28000000,31341940,31341940,3341940,3341940,72.7427152513,18.5498843779,19.1399013444,8,0,0,
3 Days to Kill,1757,28000000,30697999,33622417,2697999,5622417,72.7427152513,18.5697269238,19.1367595729,17,0,0,
Kick-Ass 2,1758,28000000,28795985,63129909,795985,35129909,72.7427152513,18.796237359,19.1274216399,71,0,0,
We Own the Night,1759,28000000,28563179,55307857,563179,27307857,72.7427152513,18.7410097993,19.1262726665,38,0,0,
A Walk Among the Tombstones,1760,28000000,26017685,42517685,-1982315,14517685,72.7427152513,18.6435676784,19.1136229336,53,0,0,
The Spy Next Door,1761,28000000,24307106,50983364,-3692894,22983364,72.7427152513,18.7091145788,19.1050314841,62,0,0,
Brick Mansions,1762,28000000,20396829,50236829,-7603171,22236829,72.7427152513,18.7035040643,19.085110241,96,0,0,
Just My Luck,1763,28000000,17326650,38159905,-10673350,10159905,72.7427152513,18.6080739764,19.0691859923,87,0,0,
Lost Souls,1764,28000000,16779636,31320293,-11220364,3320293,72.7427152513,18.5496941271,19.0663219597,2,0,0,
Winged Migration,1765,28000000,10762178,38208108,-17237822,10208108,72.7427152513,18.6084735562,19.0342623893,62,0,0,
"Mystery, Alaska",1766,28000000,8888143,8888143,-19111857,-19111857,72.7427152513,18.3300816845,19.0240643857,83,0,0,
John Carpenter's Ghosts of Mars,1767,28000000,8434601,8434601,-19565399,-19565399,72.7427152513,18.3251038017,19.0215806204,31,0,0,
A Simple Wish,1768,28000000,8119205,8119205,-19880795,-19880795,72.7427152513,18.3216274847,19.0198497502,71,0,0,
Our Brand is Crisis,1769,28000000,6958377,7505665,-21041623,-20494335,72.7427152513,18.3148301861,19.013453281,5,0,0,
Kundun,1770,28000000,5532301,5532301,-22467699,-22467699,72.7427152513,18.2926489779,19.0055388025,36,0,0,
How to Lose Friends & Alienate People,1771,28000000,2775593,12031443,-25224407,-15968557,72.7427152513,18.3639165643,18.9900596543,1,0,0,
Knocked Up,1774,27500000,148761765,219265952,121261765,191765952,72.4157734258,19.5266531934,19.5937914329,89,0,0,
Octopussy,1775,27500000,62440579,182040579,34940579,154540579,72.4157734258,19.3952057457,19.2830722627,92,0,0,
My Sister's Keeper,1776,27500000,49200230,96673002,21700230,69173002,72.4157734258,19.0063721264,19.2255551094,34,0,0,
Welcome Home Roscoe Jenkins,1777,27500000,42168445,43339555,14668445,15839555,72.4157734258,18.6540898003,19.1936079793,35,0,0,
Joyful Noise,1778,27500000,30932113,31157914,3432113,3657914,72.4157734258,18.5526572935,19.1403405093,97,0,0,
A Passage to India,1779,27500000,27187653,27187653,-312347,-312347,72.4157734258,18.5172437297,19.1219398041,39,0,0,
Notes on a Scandal,1780,27500000,17510118,50578411,-9989882,23078411,72.4157734258,18.7098266421,19.0727529762,20,0,0,
Rendition,1781,27500000,9736045,26939925,-17763955,-560075,72.4157734258,18.5149919432,19.031409797,99,0,0,
Anonymous,1782,27500000,4463292,15815509,-23036708,-11684491,72.4157734258,18.4082614529,19.0023633336,31,0,0,
Limitless,1783,27000000,79249455,155564919,52249455,128564919,72.084342424,19.2920375431,19.3535956297,63,0,0,
Star Trek VI: The Undiscovered Country,1784,27000000,74888996,96900000,47888996,69900000,72.084342424,19.0104113072,19.3362925134,25,0,0,
The Divine Secrets of the Ya-Ya Sisterhood,1785,27000000,69586544,73826768,42586544,46826768,72.084342424,18.8735192036,19.3148398277,53,0,0,
Kiss the Girls,1786,27000000,60491560,60491560,33491560,33491560,72.084342424,18.7849196231,19.2769364245,93,0,0,
The Blues Brothers,1787,27000000,57229890,57229890,30229890,30229890,72.084342424,18.7619993039,19.2629856359,10,0,0,
The Sisterhood of the Traveling Pants 2,1788,27000000,44089964,44270131,17089964,17270131,72.084342424,18.6653538463,19.2047251315,71,0,0,
The Jungle Book,1789,27000000,43054607,43054607,16054607,16054607,72.084342424,18.6557911975,19.1999869417,70,0,0,
About a Boy,1790,27000000,40803000,130759651,13803000,103759651,72.084342424,19.1824669008,19.1896045655,70,0,0,
Spy Kids: All the Time in the World,1791,27000000,38536376,80681183,11536376,53681183,72.084342424,18.9161780369,19.1790429215,65,0,0,
Lake Placid,1792,27000000,31770413,31770413,4770413,4770413,72.084342424,18.5623595871,19.1468357914,41,0,0,
Lucky Number Slevin,1793,27000000,22495466,55495466,-4504534,28495466,72.084342424,18.7495938249,19.1009290253,98,0,0,
The Right Stuff,1794,27000000,21192102,21192102,-5807898,-5807898,72.084342424,18.4660588461,19.0943057152,19,0,0,
Die Unendliche Geschichte,1795,27000000,20158808,20158808,-6841192,-6841192,72.084342424,18.4561352393,19.0890234668,79,0,0,
Dark City,1796,27000000,14337579,27159564,-12662421,159564,72.084342424,18.5215193051,19.0587321467,25,0,0,
The Duchess,1797,27000000,13848978,45160110,-13151022,18160110,72.084342424,18.6722978643,19.056147428,12,0,0,
Case 39,1798,27000000,13261851,28773827,-13738149,1773827,72.084342424,18.5360080469,19.0530326394,14,0,0,
The Honeymooners,1799,27000000,12834849,13174426,-14165151,-13825574,72.084342424,18.386344629,19.0507612264,54,0,0,
Return to Oz,1800,27000000,10618813,10618813,-16381187,-16381187,72.084342424,18.3595396983,19.03888956,52,0,0,
The Newton Boys,1801,27000000,10297897,10297897,-16702103,-16702103,72.084342424,18.3561223721,19.0371586181,79,0,0,
Suspect Zero,1802,27000000,8712564,8712564,-18287436,-18287436,72.084342424,18.3390672016,19.0285634844,3,0,0,
The Martian Child,1803,27000000,7500310,9352089,-19499690,-17647911,72.084342424,18.3459823161,19.0219408497,8,0,0,
Formula 51,1804,27000000,5204007,5204007,-21795993,-21795993,72.084342424,18.3002545195,19.0092744609,32,0,0,
Flawless,1805,27000000,4485485,4485485,-22514515,-22514515,72.084342424,18.2921167307,19.0052779168,51,0,0,
Mindhunters,1806,27000000,4476235,16566235,-22523765,-10433765,72.084342424,18.4208455005,19.0052263624,43,0,0,
What Just Happened,1807,27000000,1090947,2412123,-25909053,-24587877,72.084342424,18.2682561653,18.9861778772,52,0,0,
The Statement,1808,27000000,765637,1545064,-26234363,-25454936,72.084342424,18.2581065895,18.984328154,61,0,0,
Paul Blart: Mall Cop,1810,26000000,146336178,185904750,120336178,159904750,71.4074191775,19.4152464386,19.5909235305,91,0,0,
Freaky Friday,1811,26000000,110222438,160822438,84222438,134822438,71.4074191775,19.3178811292,19.4720747889,26,0,0,
The 40 Year-old Virgin,1812,26000000,109243478,177138471,83243478,151138471,71.4074191775,19.3822840306,19.4686479457,2,0,0,
Shakespeare in Love,1813,26000000,100241322,279423528,74241322,253423528,71.4074191775,19.7123175798,19.4365729549,90,0,0,
Kindergarten Cop,1814,26000000,88846113,199388425,62846113,173388425,71.4074191775,19.4639165608,19.3944379263,1,0,0,
The Pineapple Express,1815,26000000,87341380,102404019,61341380,76404019,71.4074191775,19.0458395181,19.3887389216,3,0,0,
Philadelphia,1816,26000000,76512063,200512063,50512063,174512063,71.4074191775,19.4678674664,19.3467371719,24,0,0,
Ever After: A Cinderella Story,1817,26000000,65703412,65703412,39703412,39703412,71.4074191775,18.8271696878,19.3029791601,44,0,0,
Flatliners,1818,26000000,61308153,61308153,35308153,35308153,71.4074191775,18.7974609802,19.2846227784,99,0,0,
Open Range,1819,26000000,58331254,68613992,32331254,42613992,71.4074191775,18.8463682214,19.2719958459,76,0,0,
Red Eye,1820,26000000,57891803,96666486,31891803,70666486,71.4074191775,19.0146522875,19.2701182737,52,0,0,
New Year's Eve,1821,26000000,54544638,143663899,28544638,117663899,71.4074191775,19.2453566801,19.2557005032,58,0,0,
A Bridge Too Far,1822,26000000,50800000,50800000,24800000,24800000,71.4074191775,18.722637265,19.2393203706,18,0,0,
Pain & Gain,1823,26000000,49875291,81275291,23875291,55275291,71.4074191775,18.9258435623,19.2352337765,53,0,0,
Final Destination 2,1824,26000000,46896664,90396664,20896664,64396664,71.4074191775,18.9794213262,19.2219555408,92,0,0,
"O Brother, Where Art Thou?",1825,26000000,45506619,75763814,19506619,49763814,71.4074191775,18.8920213291,19.215698086,63,0,0,
In Good Company,1826,26000000,45489752,63489752,19489752,37489752,71.4074191775,18.8123173036,19.2156219162,90,0,0,
Legion,1827,26000000,40122938,67602432,14122938,41602432,71.4074191775,18.8397375583,19.1910864168,13,0,0,
Lawless,1828,26000000,37397291,51932335,11397291,25932335,71.4074191775,18.7309745607,19.1783911891,39,0,0,
Clockstoppers,1829,26000000,36985501,38788828,10985501,12788828,71.4074191775,18.6296366855,19.176459106,15,0,0,
Silverado,1830,26000000,32076721,32076721,6076721,6076721,71.4074191775,18.5736332463,19.1531353743,40,0,0,
The Best of Me,1832,26000000,26766213,27866213,766213,1866213,71.4074191775,18.5368309362,19.127274779,91,0,0,
Agent Cody Banks 2: Destination London,1833,26000000,23514247,28703083,-2485753,2703083,71.4074191775,18.5442543155,19.1111020527,4,0,0,
Original Sin,1834,26000000,16521410,16521410,-9478590,-9478590,71.4074191775,18.4303503622,19.0754130878,67,0,0,
The Raven,1835,26000000,16008272,26254942,-9991728,254942,71.4074191775,18.5223812259,19.0727433591,76,0,0,
Welcome to Mooseport,1836,26000000,14469428,14469428,-11530572,-11530572,71.4074191775,18.4098186647,19.0646941336,73,0,0,
Highlander III: The Sorcerer,1837,26000000,13738574,13738574,-12261426,-12261426,71.4074191775,18.4024028769,19.0608484462,69,0,0,
Self/Less,1838,26000000,12279691,27516710,-13720309,1516710,71.4074191775,18.5337143144,19.0531274261,12,0,0,
The Curse of the Jade Scorpion,1839,26000000,7496522,18496522,-18503478,-7503478,71.4074191775,18.4497225583,19.0273864379,48,0,0,
The Fifth Estate,1840,26000000,3254172,6154172,-22745828,-19845828,71.4074191775,18.3220134896,19.0039879076,67,0,0,
Blood and Wine,1841,26000000,1075288,1075288,-24924712,-24924712,71.4074191775,18.2643254859,18.9917541224,63,0,0,
The Grimm Brothers' Snow White,1842,26000000,5000,5000,-25995000,-25995000,71.4074191775,18.2517322716,18.9856895122,81,0,0,
Flipper,1846,25530000,20047715,30561008,-5482285,5031008,71.0825016348,18.5646187372,19.0959644994,3,0,0,
The Constant Gardener,1847,25500000,33579798,86301599,8079798,60801599,71.0616103757,18.9586457855,19.1627186503,38,0,0,
W.,1848,25100000,25534493,28575778,434493,3475778,70.7812829776,18.5510598484,19.1256369922,61,0,0,
The Passion of the Christ,1849,25000000,370782930,622420667,345782930,597420667,70.7106781187,20.3777723031,20.1212825267,25,0,0,
Mrs. Doubtfire,1850,25000000,218692701,440783653,193692701,415783653,70.7106781187,20.0812563392,19.7960001551,55,0,0,
The Help,1851,25000000,169705587,213120004,144705587,188120004,70.7106781187,19.5145157931,19.6638172637,66,0,0,
Rain Man,1852,25000000,168106313,408080878,143106313,383080878,70.7106781187,20.0170964746,19.6591930351,38,0,0,
Gran Torino,1853,25000000,148095302,274543085,123095302,249543085,70.7106781187,19.7015960532,19.5994484201,85,0,0,
Taken,1854,25000000,145000989,226941585,120000989,201941585,70.7106781187,19.5597688136,19.589882926,87,0,0,
Ride Along,1855,25000000,134202565,153733265,109202565,128733265,70.7106781187,19.292741627,19.5557660191,8,0,0,
The Bodyguard,1856,25000000,111634286,400588566,86634286,375588566,70.7106781187,20.0017990305,19.4804676789,79,0,0,
Schindler's List,1857,25000000,95494598,320792986,70494598,295792986,70.7106781187,19.822462622,19.4229139848,18,0,0,
"Legally Blonde 2: Red, White & Blonde",1858,25000000,90168825,124868825,65168825,99868825,70.7106781187,19.1641363023,19.4031716632,76,0,0,
Scooby-Doo 2: Monsters Unleashed,1859,25000000,84185387,181185387,59185387,156185387,70.7106781187,19.401393599,19.3805163188,26,0,0,
Anchorman: The Legend of Ron Burgundy,1860,25000000,84136909,89476265,59136909,64476265,70.7106781187,18.9798764837,19.3803306522,36,0,0,
Freddy vs. Jason,1861,25000000,82490748,114444496,57490748,89444496,70.7106781187,19.113301476,19.3740054498,63,0,0,
Bridge to Terabithia,1862,25000000,82234139,137984788,57234139,112984788,70.7106781187,19.2246312363,19.3730158421,4,0,0,
Jimmy Neutron: Boy Genius,1863,25000000,80936232,102992536,55936232,77992536,70.7106781187,19.0543049538,19.3679954295,63,0,0,
Cloverfield,1864,25000000,80048433,171302226,55048433,146302226,70.7106781187,19.3636230192,19.3645467744,84,0,0,
Dear John,1865,25000000,80014842,142033509,55014842,117033509,70.7106781187,19.2425893697,19.3644160564,32,0,0,
Parental Guidance,1866,25000000,77267296,120168633,52267296,95168633,70.7106781187,19.1415348919,19.3536658147,92,0,0,
Teenage Mutant Ninja Turtles II: The Secret of the Ooze,1867,25000000,76323571,76323571,51323571,51323571,70.7106781187,18.9017097016,19.349946503,39,0,0,
The Untouchables,1868,25000000,75729280,75729280,50729280,50729280,70.7106781187,18.8980293453,19.3475972261,57,0,0,
No Country for Old Men,1869,25000000,74273505,164051250,49273505,139051250,70.7106781187,19.3349754531,19.3418190116,29,0,0,
Bridget Jones's Diary,1870,25000000,71500556,281527158,46500556,256527158,70.7106781187,19.7208108238,19.3307194808,51,0,0,
Chocolat,1871,25000000,71309760,152500343,46309760,127500343,70.7106781187,19.2875735841,19.3299512154,60,0,0,
No Strings Attached,1872,25000000,70662220,149228078,45662220,124228078,70.7106781187,19.2737262834,19.3273394,51,0,0,
Contraband,1873,25000000,66528000,98406855,41528000,73406855,70.7106781187,19.0296693671,19.3105015008,79,0,0,
The Lucky One,1874,25000000,60457138,96633833,35457138,71633833,70.7106781187,19.019979089,19.285250549,38,0,0,
Tombstone,1875,25000000,56505065,56505065,31505065,31505065,70.7106781187,18.7710228267,19.2684629985,3,0,0,
Romeo Must Die,1876,25000000,55973336,91036760,30973336,66036760,70.7106781187,18.9887577886,19.2661826655,40,0,0,
Final Destination 3,1878,25000000,54098051,112798051,29098051,87798051,70.7106781187,19.1050308082,19.2580986956,18,0,0,
Tyler Perry's A Madea Christmas,1879,25000000,52543354,52543354,27543354,27543354,70.7106781187,18.7427178363,19.2513468097,75,0,0,
Finding Neverland,1880,25000000,51676606,115036108,26676606,90036108,70.7106781187,19.1162567226,19.2475627271,54,0,0,
The Grey,1881,25000000,51580136,84339696,26580136,59339696,70.7106781187,18.9500725722,19.2471406677,74,0,0,
Hide and Seek,1882,25000000,51100486,123696741,26100486,98696741,70.7106781187,19.1585478307,19.2450395342,88,0,0,
The House Bunny,1883,25000000,48237389,71390601,23237389,46390601,70.7106781187,18.8707421103,19.2324049116,4,0,0,
Agent Cody Banks,1884,25000000,47545060,58240458,22545060,33240458,70.7106781187,18.7831736309,19.2293255997,73,0,0,
Nanny McPhee,1885,25000000,47124400,128590699,22124400,103590699,70.7106781187,19.1816778678,19.2274499642,76,0,0,
Goodfellas,1886,25000000,46261759,46261759,21261759,21261759,70.7106781187,18.6961282864,19.2235925877,27,0,0,
The Giver,1887,25000000,45090374,55090374,20090374,30090374,70.7106781187,18.7610070869,19.2183307,3,0,0,
Scarface,1888,25000000,44942821,44942821,19942821,19942821,70.7106781187,18.6860640083,19.2176659208,46,0,0,
Nothing To Lose,1889,25000000,44477235,64591257,19477235,39591257,70.7106781187,18.8264224739,19.2155653869,8,0,0,
The Hours,1890,25000000,41597830,96952304,16597830,71952304,70.7106781187,19.0217265939,19.2024757373,28,0,0,
Money Talks,1891,25000000,41067398,41067398,16067398,16067398,70.7106781187,18.6558923031,19.2000456154,5,0,0,
The Last Emperor,1892,25000000,40295591,40295591,15295591,15295591,70.7106781187,18.6497732293,19.1964990764,67,0,0,
There Will Be Blood,1893,25000000,40222514,77208711,15222514,52208711,70.7106781187,18.907166254,19.1961626267,63,0,0,
The Wild Thornberrys Movie,1894,25000000,39882925,60468965,14882925,35468965,70.7106781187,18.7985636499,19.1945976571,64,0,0,
Rugrats Go Wild,1895,25000000,39402572,55443032,14402572,30443032,70.7106781187,18.7635132398,19.1923797969,92,0,0,
The Sisterhood of the Traveling Pants,1896,25000000,39008741,41515797,14008741,16515797,70.7106781187,18.6594301993,19.1905577445,70,0,0,
Undercover Brother,1897,25000000,38230435,40796145,13230435,15796145,70.7106781187,18.653746008,19.1869471323,23,0,0,
August:  Osage County,1898,25000000,37738810,50738810,12738810,25738810,70.7106781187,18.7295545667,19.1846597155,26,0,0,
Kiss of the Dragon,1899,25000000,36833473,36833473,11833473,11833473,70.7106781187,18.6218544357,19.1804336544,50,0,0,
Million Dollar Arm,1900,25000000,36447959,36947959,11447959,11947959,70.7106781187,18.6227902303,19.1786286613,48,0,0,
Beauty Shop,1901,25000000,36351350,38351350,11351350,13351350,70.7106781187,18.6341907777,19.1781758228,6,0,0,
What a Girl Wants,1902,25000000,35990505,35990505,10990505,10990505,70.7106781187,18.6149370229,19.1764826068,82,0,0,
Jeepers Creepers II,1903,25000000,35623801,119923801,10623801,94923801,70.7106781187,19.1403434746,19.1747589559,12,0,0,
Good Luck Chuck,1904,25000000,35017297,59183821,10017297,34183821,70.7106781187,18.7897174071,19.1719016155,74,0,0,
Cradle 2 the Grave,1905,25000000,34657731,56434942,9657731,31434942,70.7106781187,18.7705287252,19.1702037778,57,0,0,
She's the Man,1906,25000000,33687630,55078079,8687630,30078079,70.7106781187,18.7609195994,19.1656086174,68,0,0,
Mr. Bean's Holiday,1908,25000000,32589350,234268525,7589350,209268525,70.7106781187,19.5829523142,19.1603806876,0,0,0,
Bride of Chucky,1909,25000000,32368960,50656960,7368960,25656960,70.7106781187,18.7289533833,19.1593283071,40,0,0,
August Rush,1910,25000000,31664162,66015869,6664162,41015869,70.7106781187,18.8358724682,19.155955385,74,0,0,
Anacondas: The Hunt for the Blood Orchid,1911,25000000,31526393,70326393,6526393,45326393,70.7106781187,18.8639337123,19.1552947383,0,0,0,
The Sitter,1912,25000000,30542576,32457751,5542576,7457751,70.7106781187,18.585415158,19.1505642899,83,0,0,
Elizabeth,1913,25000000,30012990,82080933,5012990,57080933,70.7106781187,18.9366800114,19.1480086071,79,0,0,
"Tora, Tora, Tora",1914,25000000,29548291,29548291,4548291,4548291,70.7106781187,18.5604299298,19.1457606641,19,0,0,
Spice World,1915,25000000,29247405,55947405,4247405,30947405,70.7106781187,18.7670866706,19.144302453,7,0,0,
Draft Day,1916,25000000,28842237,28842237,3842237,3842237,70.7106781187,18.5542713262,19.1423354851,21,0,0,
The Shawshank Redemption,1917,25000000,28233104,28233104,3233104,3233104,70.7106781187,18.5489274749,19.139371029,20,0,0,
Dance Flick,1918,25000000,25662155,32092761,662155,7092761,70.7106781187,18.5823148077,19.1267613066,76,0,0,
Crocodile Dundee in Los Angeles,1919,25000000,25590119,39393111,590119,14393111,70.7106781187,18.6425703335,19.1264056918,57,0,0,
Kingpin,1920,25000000,24879969,32079969,-120031,7079969,70.7106781187,18.5822059735,19.1228931609,49,0,0,
Ice Princess,1921,25000000,24381334,25732334,-618666,732334,70.7106781187,18.5266842369,19.1204194278,96,0,0,
Don't Be Afraid of the Dark,1922,25000000,24046682,39126427,-953318,14126427,70.7106781187,18.6404318997,19.1187557777,19,0,0,
The Losers,1923,25000000,23591432,29863840,-1408568,4863840,70.7106781187,18.5631701114,19.116488148,21,0,0,
War,1924,25000000,22486409,40686409,-2513591,15686409,70.7106781187,18.6528764091,19.1109624731,18,0,0,
Don Juan DeMarco,1925,25000000,22011141,22011141,-2988859,-2988859,70.7106781187,18.4926421132,19.1085764698,46,0,0,
A Lot Like Love,1926,25000000,21835784,47835784,-3164216,22835784,70.7106781187,18.7080079485,19.1076946796,1,0,0,
He Got Game,1927,25000000,21554585,22398680,-3445415,-2601320,70.7106781187,18.4962419355,19.1062790332,71,0,0,
The Eagle,1928,25000000,19490041,36054706,-5509959,11054706,70.7106781187,18.6154655443,19.0958236255,99,0,0,
Shark Night 3D,1929,25000000,18877153,32209741,-6122847,7209741,70.7106781187,18.583309523,19.092698635,31,0,0,
Punch-Drunk Love,1930,25000000,17791031,24591031,-7208969,-408969,70.7106781187,18.5163660626,19.0871366199,84,0,0,
Eurotrip,1931,25000000,17718223,20718223,-7281777,-4281777,70.7106781187,18.480537683,19.0867626625,58,0,0,
The Ruins,1932,25000000,17432844,22910563,-7567156,-2089437,70.7106781187,18.5009770042,19.0852955451,30,0,0,
The Counselor,1933,25000000,16973715,71009334,-8026285,46009334,70.7106781187,18.8683082343,19.0829306624,18,0,0,
Unaccompanied Minors,1934,25000000,16655224,21970831,-8344776,-3029169,70.7106781187,18.4922669313,19.0812868866,5,0,0,
"Bright Lights, Big City",1935,25000000,16118077,16118077,-8881923,-8881923,70.7106781187,18.4362422237,19.0785084612,34,0,0,
Half Past Dead,1936,25000000,15567860,19233280,-9432140,-5766720,70.7106781187,18.4664522806,19.0756544041,39,0,0,
Legend,1937,25000000,15502112,23506237,-9497888,-1493763,70.7106781187,18.5064590853,19.075312814,25,0,0,
The Greatest Game Ever Played,1938,25000000,15331289,15425073,-9668711,-9574927,70.7106781187,18.4293958073,19.0744247668,5,0,0,
The Box,1939,25000000,15051977,26341896,-9948023,1341896,70.7106781187,18.5321517943,19.0729710232,95,0,0,
The Adventures of Pinocchio,1940,25000000,14988577,36288577,-10011423,11288577,70.7106781187,18.6173884801,19.0726407488,48,0,0,
The Next Best Thing,1941,25000000,14983572,24355762,-10016428,-644238,70.7106781187,18.5142257669,19.0726146712,60,0,0,
My Soul to Take,1942,25000000,14744435,16727470,-10255565,-8272530,70.7106781187,18.4422241299,19.0713679017,76,0,0,
The Girl Next Door,1943,25000000,14589444,31635150,-10410556,6635150,70.7106781187,18.5784140728,19.0705590065,47,0,0,
Fly Me To the Moon,1944,25000000,14543943,43530281,-10456057,18530281,70.7106781187,18.6751719665,19.0703214133,74,0,0,
Maximum Risk,1945,25000000,14039438,51639438,-10960562,26639438,70.7106781187,18.7361458682,19.0676832428,58,0,0,
Stealing Harvard,1946,25000000,13973532,13973532,-11026468,-11026468,70.7106781187,18.4149018182,19.0673380909,15,0,0,
Hot Rod,1947,25000000,13938332,14334401,-11061668,-10665599,70.7106781187,18.4185248518,19.0671536985,67,0,0,
Warrior,1948,25000000,13657115,24215385,-11342885,-784615,70.7106781187,18.5129465399,19.0656793435,28,0,0,
Angela's Ashes,1949,25000000,13038660,13038660,-11961340,-11961340,70.7106781187,18.4054544298,19.0624292615,4,0,0,
Cirque du Soleil: Worlds Away,1950,25000000,12512862,28012862,-12487138,3012862,70.7106781187,18.5469882672,19.0596577749,45,0,0,
Lifeforce,1951,25000000,11603545,11603545,-13396455,-13396455,70.7106781187,18.390775888,19.0548465525,16,0,0,
The Conspirator,1952,25000000,11538204,15907411,-13461796,-9092589,70.7106781187,18.4341659387,19.0544999383,53,0,0,
The 33,1953,25000000,11450463,22807951,-13549537,-2192049,70.7106781187,18.500029608,19.0540343099,59,0,0,
The Powerpuff Girls,1954,25000000,11411644,16425701,-13588356,-8574299,70.7106781187,18.439266386,19.053828234,91,0,0,
Michael Collins,1955,25000000,11030963,27511248,-13969037,2511248,70.7106781187,18.5425575222,19.0518050844,78,0,0,
The Lords of Dogtown,1956,25000000,11008432,13159280,-13991568,-11840720,70.7106781187,18.406678387,19.0516852138,38,0,0,
Stop-Loss,1957,25000000,10915744,11229035,-14084256,-13770965,70.7106781187,18.3869096356,19.0511919391,55,0,0,
Big Trouble in Little China,1958,25000000,10911690,10911690,-14088310,-14088310,70.7106781187,18.3836217854,19.0511703587,93,0,0,
Gettysburg,1959,25000000,10731997,10731997,-14268003,-14268003,70.7106781187,18.3817552729,19.0502133391,78,0,0,
Abandon,1960,25000000,10719367,12219367,-14280633,-12780633,70.7106781187,18.3971010042,19.0501460391,7,0,0,
Straw Dogs,1961,25000000,10324441,11253821,-14675559,-13746179,70.7106781187,18.3871659762,19.0480393531,100,0,0,
Brokedown Palace,1962,25000000,10115014,11115766,-14884986,-13884234,70.7106781187,18.3857373533,19.0469203862,45,0,0,
Possession,1963,25000000,10103647,14805812,-14896353,-10194188,70.7106781187,18.4232380115,19.0468596166,76,0,0,
Mrs. Winterbourne,1964,25000000,10039566,10039566,-14960434,-14960434,70.7106781187,18.3745300773,19.0465169611,96,0,0,
Stone Cold,1965,25000000,9286314,9286314,-15713686,-15713686,70.7106781187,18.3666105028,19.0424803275,8,0,0,
The Road,1966,25000000,8114270,29206732,-16885730,4206732,70.7106781187,18.5574553941,19.0361668298,48,0,0,
The Hoax,1967,25000000,7164995,7164995,-17835005,-17835005,70.7106781187,18.3439642326,19.0310239531,4,0,0,
Sheena,1968,25000000,5778353,5778353,-19221647,-19221647,70.7106781187,18.3288789477,19.0234637003,21,0,0,
Underclassman,1969,25000000,5654777,5654777,-19345223,-19345223,70.7106781187,18.3275234541,19.0227871568,9,0,0,
Say It Isn't So,1970,25000000,5516708,5516708,-19483292,-19483292,70.7106781187,18.3260068118,19.0220307265,57,0,0,
The World's Fastest Indian,1971,25000000,5128124,18991288,-19871876,-6008712,70.7106781187,18.4641379513,19.0198987383,31,0,0,
Deception,1972,25000000,4598506,12850033,-20401494,-12149967,70.7106781187,18.4035373828,19.0169856202,77,0,0,
King's Ransom,1973,25000000,4008527,4049527,-20991473,-20950473,70.7106781187,18.3097466023,19.013730468,24,0,0,
Tank Girl,1974,25000000,3817132,3817132,-21182868,-21182868,70.7106781187,18.3071466265,19.0126721842,69,0,0,
Blindness,1975,25000000,3073392,20052958,-21926608,-4947042,70.7106781187,18.4742518423,19.0085491445,6,0,0,
Carnage,1976,25000000,2546747,38112154,-22453253,13112154,70.7106781187,18.6322568173,19.0056192902,72,0,0,
BloodRayne,1977,25000000,2405420,3605420,-22594580,-21394580,70.7106781187,18.304772148,19.0048315907,91,0,0,
Bad Lieutenant: Port of Call New Orleans,1978,25000000,1702112,8162545,-23297888,-16837455,70.7106781187,18.3546775455,19.0009023828,79,0,0,
Me and Orson Welles,1979,25000000,1190003,1190003,-23809997,-23809997,70.7106781187,18.2772749886,18.9980316116,6,0,0,
Venom,1980,25000000,881745,881745,-24118255,-24118255,70.7106781187,18.2737107364,18.9962996027,27,0,0,
Where the Truth Lies,1981,25000000,872142,1415656,-24127858,-23584344,70.7106781187,18.2798760853,18.9962455981,53,0,0,
Without Limits,1982,25000000,777423,777423,-24222577,-24222577,70.7106781187,18.2725016239,18.9957127688,2,0,0,
On the Road,1983,25000000,720828,9264551,-24279172,-15735449,70.7106781187,18.3663807551,18.9953942654,29,0,0,
Les petits mouchoirs,1984,25000000,205505,48530887,-24794495,23530887,70.7106781187,18.7132095197,18.9924894722,74,0,0,
Love Ranch,1985,25000000,137885,137885,-24862115,-24862115,70.7106781187,18.2650571283,18.992107682,84,0,0,
Yi ge ren de wu lin,1986,25000000,129115,129115,-24870885,-24870885,70.7106781187,18.2649546556,18.9920581549,75,0,0,
Star Trek IV: The Voyage Home,1997,24000000,107109310,130396178,83109310,106396178,69.9927102316,19.194699919,19.4681773751,88,0,0,
Scream 2,1998,24000000,101334374,101334374,77334374,77334374,69.9927102316,19.0508062045,19.447710006,62,0,0,
Old School,1999,24000000,75155000,86765463,51155000,62765463,69.9927102316,18.9700482256,19.3492806897,32,0,0,
Rocky Balboa,2000,24000000,70269899,156229050,46269899,132229050,69.9927102316,19.3072513437,19.3297906352,17,0,0,
Think Like a Man Too,2001,24000000,65028687,70027933,41028687,46027933,69.9927102316,18.8684271014,19.3084485699,83,0,0,
The Whole Nine Yards,2002,24000000,57262492,85527867,33262492,61527867,69.9927102316,18.9628777535,19.2759629856,18,0,0,
Point Break,2004,24000000,43218387,83531958,19218387,59531958,69.9927102316,18.9512042837,19.2143956592,84,0,0,
The Fisher King,2005,24000000,41798224,41798224,17798224,17798224,69.9927102316,18.669480081,19.2079535167,73,0,0,
I Still Know What You Did Last Summer,2006,24000000,39989088,39989088,15989088,15989088,69.9927102316,18.6552731464,19.1996863451,63,0,0,
"Hello, Dolly",2007,24000000,33208099,33208099,9208099,9208099,69.9927102316,18.6001510816,19.1680765925,86,0,0,
Return to Me,2008,24000000,32662299,32662299,8662299,8662299,69.9927102316,18.5955793269,19.1654883465,71,0,0,
The Men Who Stare at Goats,2009,24000000,32428195,67348218,8428195,43348218,69.9927102316,18.851153602,19.1643761424,94,0,0,
Zack and Miri Make a Porno,2010,24000000,31457946,36856306,7457946,12856306,69.9927102316,18.6301840731,19.159753356,15,0,0,
Double Take,2011,24000000,29823162,29823162,5823162,5823162,69.9927102316,18.571454907,19.1519157029,15,0,0,
"Girl, Interrupted",2012,24000000,28871190,28871190,4871190,4871190,69.9927102316,18.5632338484,19.1473231969,31,0,0,
Nurse Betty,2013,24000000,25170054,27732366,1170054,3732366,69.9927102316,18.5533095495,19.1292650319,54,0,0,
Piranha 3D,2014,24000000,25003155,83660160,1003155,59660160,69.9927102316,18.9519582078,19.1284429824,44,0,0,
Faster,2015,24000000,23240020,35792945,-759980,11792945,69.9927102316,18.6215229548,19.1197172534,69,0,0,
Win a Date with Tad Hamilton!,2016,24000000,16980098,16980098,-7019902,-7019902,69.9927102316,18.4544089007,19.0881070559,24,0,0,
Muppets From Space,2017,24000000,16304786,16304786,-7695214,-7695214,69.9927102316,18.4478583445,19.0846365059,41,0,0,
The Wiz,2018,24000000,13000000,13000000,-11000000,-11000000,69.9927102316,18.4151679967,19.067476719,73,0,0,
Ready to Rumble,2019,24000000,12372410,12372410,-11627590,-11627590,69.9927102316,18.4088374078,19.0641844842,20,0,0,
I Don't Know How She Does It,2020,24000000,9659074,24474463,-14340926,474463,69.9927102316,18.5243621959,19.0498247001,43,0,0,
Play it to the Bone,2021,24000000,8427204,8427204,-15572796,-15572796,69.9927102316,18.3680965747,19.0432365887,85,0,0,
Beyond the Sea,2022,24000000,6144806,8292914,-17855194,-15707086,69.9927102316,18.3666801672,19.0309142876,0,0,0,
Hauru no ugoku shiro,2023,24000000,4710455,237814327,-19289545,213814327,69.9927102316,19.5970703116,19.0230920347,79,0,0,
Meet the Deedles,2024,24000000,4351341,4351341,-19648659,-19648659,69.9927102316,18.3241872775,19.0211239866,6,0,0,
The Princess and the Cobbler,2025,24000000,635381,635381,-23364619,-23364619,69.9927102316,18.2824023652,19.00052877,49,0,0,
The Bridge of San Luis Rey,2026,24000000,49981,1696765,-23950019,-22303235,69.9927102316,18.2945165129,18.997245242,31,0,0,
Zombieland,2027,23600000,75590286,102236596,51990286,78636596,69.6992332856,19.0577169279,19.352575525,11,0,0,
Star Wars Ep. V: The Empire Strikes Back,2028,23000000,290158751,534058751,267158751,511058751,69.2519423793,20.2476609387,19.9663266768,61,0,0,
The Waterboy,2029,23000000,161487252,190187252,138487252,167187252,69.2519423793,19.4418268424,19.6457158907,65,0,0,
The Naked Gun 2½: The Smell of Fear,2030,23000000,85748264,85748264,62748264,62748264,69.2519423793,18.9699489282,19.39406832,54,0,0,
Bad Boys,2031,23000000,65637842,141237842,42637842,118237842,69.2519423793,19.2478695545,19.3150495896,58,0,0,
Final Destination,2032,23000000,53302314,112036870,30302314,89036870,69.2519423793,19.1112601908,19.2632975295,4,0,0,
The Ides of March,2034,23000000,40962534,77735925,17962534,54735925,69.2519423793,18.9225836807,19.2087009861,35,0,0,
Pitch Black,2035,23000000,39235088,53182088,16235088,30182088,69.2519423793,18.7616594541,19.2008145092,74,0,0,
Someone Like You,2036,23000000,27338033,38684906,4338033,15684906,69.2519423793,18.6528644933,19.1447418955,8,0,0,
Her,2037,23000000,25568251,48783090,2568251,25783090,69.2519423793,18.7298796502,19.1361253392,38,0,0,
Joy Ride,2038,23000000,21973182,21973182,-1026818,-1026818,69.2519423793,18.5107355385,19.1183900174,23,0,0,
Haywire,2039,23000000,18942396,36374700,-4057604,13374700,69.2519423793,18.6343793681,19.1031901283,77,0,0,
Anywhere But Here,2040,23000000,18653615,18653615,-4346385,-4346385,69.2519423793,18.4799289555,19.1017297155,89,0,0,
Vanity Fair,2041,23000000,16123851,19123851,-6876149,-3876149,69.2519423793,18.4843510102,19.0888442761,24,0,0,
Jaws 4: The Revenge,2042,23000000,15728335,15728335,-7271665,-7271665,69.2519423793,18.4519718024,19.0868146082,93,0,0,
The Crew,2043,23000000,13019253,13019253,-9980747,-9980747,69.2519423793,18.4253647071,19.0728005652,8,0,0,
Marvin's Room,2044,23000000,12782508,12782508,-10217492,-10217492,69.2519423793,18.4230055396,19.0715665039,53,0,0,
Chasing Liberty,2045,23000000,12189514,12291975,-10810486,-10708025,69.2519423793,18.4180995857,19.0684687516,94,0,0,
The Longshots,2046,23000000,11511323,11778396,-11488677,-11221604,69.2519423793,18.4129372202,19.0649141338,16,0,0,
The End of the Affair,2047,23000000,10660147,10660147,-12339853,-12339853,69.2519423793,18.4016038212,19.0604348904,10,0,0,
Harley Davidson and the Marlboro Man,2048,23000000,7018525,7018525,-15981475,-15981475,69.2519423793,18.36377983,19.0410413267,61,0,0,
In the Valley of Elah,2049,23000000,6777741,24489150,-16222259,1489150,69.2519423793,18.53346814,19.0397456705,62,0,0,
Coco avant Chanel,2050,23000000,6113834,50813834,-16886166,27813834,69.2519423793,18.7446760088,19.0361644738,21,0,0,
Cheri,2051,23000000,2715657,2715657,-20284343,-20284343,69.2519423793,18.3171618538,19.0176307305,55,0,0,
Rogue,2052,23000000,10452,4673377,-22989548,-18326623,69.2519423793,18.338641918,19.002626903,26,0,0,
Spaceballs,2054,22700000,36725144,36725144,14025144,14025144,69.0250077858,18.6396185516,19.190633699,14,0,0,
1408,2055,22500000,71975611,131253353,49475611,108753353,68.8724653998,19.2055115135,19.3426232027,47,0,0,
The Water Diviner,2056,22500000,4200117,30864649,-18299883,8364649,68.8724653998,18.5930773022,19.0284957079,39,0,0,
Ghost,2057,22000000,206143657,506112351,184143657,484112351,68.4866100769,20.2033365554,19.7715680535,27,0,0,
There's Something About Mary,2058,22000000,176483808,360099156,154483808,338099156,68.4866100769,19.9215293739,19.691634759,14,0,0,
The Santa Clause,2059,22000000,144700007,189666650,122700007,167666650,68.4866100769,19.4435520581,19.5982315247,42,0,0,
The Game Plan,2060,22000000,90648202,146590987,68648202,124590987,68.4866100769,19.2752714993,19.4161135553,80,0,0,
The Rookie,2061,22000000,75600072,80491516,53600072,58491516,68.4866100769,18.9450645863,19.3588949624,74,0,0,
The Bridges of Madison County,2062,22000000,71477088,175477088,49477088,153477088,68.4866100769,19.3911843581,19.3426290774,67,0,0,
Son of God,2063,22000000,59700064,70949793,37700064,48949793,68.4866100769,18.886927544,19.2946541347,98,0,0,
The Animal,2064,22000000,55762229,55762229,33762229,33762229,68.4866100769,18.7867982632,19.2780854294,78,0,0,
The Hundred-Foot Journey,2065,22000000,54235441,94270488,32235441,72270488,68.4866100769,19.0234694797,19.2715867814,62,0,0,
Gandhi,2066,22000000,52767889,127767889,30767889,105767889,68.4866100769,19.1917983219,19.2653002064,2,0,0,
Underworld,2067,22000000,51970690,95708457,29970690,73708457,68.4866100769,19.0313084385,19.2618685948,81,0,0,
The Net,2068,22000000,50620117,110520117,28620117,88520117,68.4866100769,19.1086664219,19.2560279272,30,0,0,
Diary of a Wimpy Kid: Dog Days,2069,22000000,49008662,77229695,27008662,55229695,68.4866100769,18.9255683949,19.2490141229,93,0,0,
I Am Sam,2070,22000000,40270895,92542418,18270895,70542418,68.4866100769,19.013967036,19.2101022576,66,0,0,
Derailed,2071,22000000,36020063,57520063,14020063,35520063,68.4866100769,18.7989137686,19.1906101719,4,0,0,
The Informant!,2072,22000000,33316821,41771168,11316821,19771168,68.4866100769,18.6847467136,19.1780139242,87,0,0,
Delivery Man,2073,22000000,30659817,36418006,8659817,14418006,68.4866100769,18.6427697235,19.1654765613,40,0,0,
Jay and Silent Bob Strike Back,2074,22000000,30059386,33762400,8059386,11762400,68.4866100769,18.6212730528,19.1626214554,47,0,0,
Shadowlands,2075,22000000,25842377,25842377,3842377,3842377,68.4866100769,18.5542725511,19.1423361654,43,0,0,
Traitor,2076,22000000,23530831,27882226,1530831,5882226,68.4866100769,18.5719627532,19.1310397083,100,0,0,
Deuce Bigalow: European Gigolo,2077,22000000,22264487,45137797,264487,23137797,68.4866100769,18.7102712867,19.1247965882,56,0,0,
Mad Money,2078,22000000,20668843,25044057,-1331157,3044057,68.4866100769,18.5472631646,19.1168741003,50,0,0,
Homefront,2079,22000000,20158492,27901338,-1841508,5901338,68.4866100769,18.5721270274,19.1143268651,9,0,0,
Igor,2080,22000000,19528602,31013349,-2471398,9013349,68.4866100769,18.5985222052,19.1111740211,73,0,0,
Saving Silverman,2081,22000000,19351569,25873142,-2648431,3873142,68.4866100769,18.5545416924,19.1102861097,56,0,0,
Summer of Sam,2082,22000000,19288130,19288130,-2711870,-2711870,68.4866100769,18.4952163647,19.1099677386,49,0,0,
The Glass House,2083,22000000,17951431,22861785,-4048569,861785,68.4866100769,18.5278478698,19.1032357854,47,0,0,
The Transporter Refueled,2084,22000000,16029670,66653404,-5970330,44653404,68.4866100769,18.8596041353,19.0934772012,75,0,0,
The Island,2085,22000000,15716828,15716828,-6283172,-6283172,68.4866100769,18.4615066106,19.0918795567,88,0,0,
Josie and the Pussycats,2086,22000000,14252830,14252830,-7747170,-7747170,68.4866100769,18.4473525869,19.084368995,52,0,0,
Hit & Run,2087,22000000,13749300,17216955,-8250700,-4783045,68.4866100769,18.4758050622,19.081772707,12,0,0,
The Little Vampire,2088,22000000,13555988,13555988,-8444012,-8444012,68.4866100769,18.4405444479,19.0807741634,35,0,0,
I Heart Huckabees,2089,22000000,12784713,20034713,-9215287,-1965287,68.4866100769,18.5021220578,19.0767802255,35,0,0,
Out of the Furnace,2090,22000000,11330849,15434375,-10669151,-6565625,68.4866100769,18.4587913894,19.0692079456,44,0,0,
RoboCop 3,2091,22000000,10696210,10696210,-11303790,-11303790,68.4866100769,18.4121086282,19.0658844396,60,0,0,
Dudley Do-Right,2092,22000000,9818792,9818792,-12181208,-12181208,68.4866100769,18.4032195203,19.0612712693,96,0,0,
Megiddo: Omega Code 2,2093,22000000,6047691,6047691,-15952309,-15952309,68.4866100769,18.3640885193,19.0411981547,90,0,0,
Darling Lili,2094,22000000,5000000,5000000,-17000000,-17000000,68.4866100769,18.3529396816,19.035549149,72,0,0,
The Libertine,2095,22000000,4835065,9448623,-17164935,-12551377,68.4866100769,18.3994455141,19.0346569277,13,0,0,
Zwartboek,2096,22000000,4398532,27238354,-17601468,5238354,68.4866100769,18.5664126221,19.0322916391,54,0,0,
Before I Go to Sleep,2097,22000000,3242457,6342457,-18757543,-15657543,68.4866100769,18.3672029496,19.0260004583,28,0,0,
Stone,2098,22000000,1810078,4065020,-20189922,-17934980,68.4866100769,18.3428841836,19.0181503718,9,0,0,
Joyeux Noël,2099,22000000,1054361,23134075,-20945639,1134075,68.4866100769,18.5302910695,19.0139837326,61,0,0,
Sorcerer,2102,21600000,12000000,12000000,-9600000,-9600000,68.173161988,18.4291472221,19.0747820653,36,0,0,
Molière,2103,21600000,635733,791154,-20964267,-20808846,68.173161988,18.3113277803,19.0138808078,86,0,0,
Michael Clayton,2104,21500000,49033882,92987651,27533882,71487651,68.0941205079,19.0191759396,19.2513055337,49,0,0,
Arlington Road,2105,21500000,24362501,24362501,2862501,2862501,68.0941205079,18.5456621911,19.1375631131,61,0,0,
My Fellow Americans,2106,21500000,22294341,22294341,794341,794341,68.0941205079,18.5272417858,19.1274135309,56,0,0,
To Rome with Love,2107,21500000,16684352,74363777,-4815648,52863777,68.0941205079,18.9111854024,19.0993520174,65,0,0,
Silver Linings Playbook,2108,21000000,132092958,236412453,111092958,215412453,67.6947242771,19.6019866697,19.5618232601,12,0,0,
"South Park: Bigger, Longer & Uncut",2109,21000000,52037603,52037603,31037603,31037603,67.6947242771,18.7677243704,19.2664585525,22,0,0,
Firefox,2110,21000000,45785720,45785720,24785720,24785720,67.6947242771,18.7225316774,19.2392573894,39,0,0,
Teenage Mutant Ninja Turtles III,2112,21000000,42273609,42273609,21273609,21273609,67.6947242771,18.6962182514,19.223645677,33,0,0,
Hardball,2113,21000000,40222729,43728560,19222729,22728560,67.6947242771,18.7072031593,19.2144152918,71,0,0,
For Colored Girls,2114,21000000,37729698,38017873,16729698,17017873,67.6947242771,18.6633768129,19.2030789621,27,0,0,
Freedom Writers,2115,21000000,36605602,43632609,15605602,22632609,67.6947242771,18.7064824322,19.1979251232,12,0,0,
The Transporter,2116,21000000,25296447,43928932,4296447,22928932,67.6947242771,18.7087065624,19.1445402748,63,0,0,
Never Back Down,2117,21000000,24850922,39319801,3850922,18319801,67.6947242771,18.6735387593,19.1423776888,96,0,0,
Tinker Tailor Soldier Spy,2118,21000000,24149393,81452811,3149393,60452811,67.6947242771,18.9566070122,19.1389629466,72,0,0,
The Bachelor,2119,21000000,21731001,36882378,731001,15882378,67.6947242771,18.654428828,19.1271010555,16,0,0,
The Rage: Carrie 2,2120,21000000,17757087,17757087,-3242913,-3242913,67.6947242771,18.4902751719,19.1072986955,92,0,0,
Swing Vote,2121,21000000,16289867,17589867,-4710133,-3410133,67.6947242771,18.4887141727,19.0998871418,66,0,0,
Away We Go,2122,21000000,9451946,10108016,-11548054,-10891984,67.6947242771,18.4162535384,19.0646023174,96,0,0,
Moonlight Mile,2123,21000000,6830957,6830957,-14169043,-14169043,67.6947242771,18.3827836242,19.0507404994,18,0,0,
The Beaver,2124,21000000,970816,5046038,-20029184,-15953962,67.6947242771,18.3640710267,19.0190343648,70,0,0,
Molly,2125,21000000,17396,17396,-20982604,-20982604,67.6947242771,18.3093875314,19.0137794804,0,0,0,
eXistenZ,2127,20700000,2840417,2840417,-17859583,-17859583,67.4516513247,18.3436988199,19.0308904452,71,0,0,
The Best Little Whorehouse in Texas,2128,20500000,69701637,69701637,49201637,49201637,67.2881309673,18.8885062466,19.3415328888,35,0,0,
Pulse,2129,20500000,20264436,30241435,-235564,9741435,67.2881309673,18.6045983348,19.122320545,83,0,0,
Raiders of the Lost Ark,2130,20000000,248159971,389925971,228159971,369925971,66.8740304976,19.990080132,19.8795313017,32,0,0,
Beauty and the Beast,2131,20000000,218951625,451421625,198951625,431421625,66.8740304976,20.1105401237,19.8092049821,81,0,0,
Home Alone 2: Lost in New York,2132,20000000,170004045,355413379,150004045,335413379,66.8740304976,19.9155236807,19.6789865113,89,0,0,
Close Encounters of the Third Kind,2133,20000000,166000000,337700000,146000000,317700000,66.8740304976,19.8749847247,19.6675444057,50,0,0,
Beverly Hills Cop II,2134,20000000,152932902,275932902,132932902,255932902,66.8740304976,19.7191901854,19.6292655656,81,0,0,
The Conjuring,2135,20000000,137400141,318000141,117400141,298000141,66.8740304976,19.8278810035,19.5817715021,9,0,0,
Bringing Down the House,2136,20000000,132675402,164675402,112675402,144675402,66.8740304976,19.3572667034,19.5668657036,12,0,0,
The Silence of the Lambs,2137,20000000,124507594,269507594,104507594,249507594,66.8740304976,19.7014974604,19.5405616274,49,0,0,
Wayne's World,2138,20000000,119352584,180752584,99352584,160752584,66.8740304976,19.4183775344,19.5235967749,99,0,0,
Jackass 3D,2139,20000000,117229692,171685793,97229692,151685793,66.8740304976,19.3843741446,19.5165259177,5,0,0,
Jaws 2,2140,20000000,102922376,208900376,82922376,188900376,66.8740304976,19.5171260798,19.4675213677,52,0,0,
Beverly Hills Chihuahua,2141,20000000,94514402,154218168,74514402,134218168,66.8740304976,19.3154144233,19.4375612323,1,0,0,
Tammy,2142,20000000,84525432,92025432,64525432,72025432,66.8740304976,19.022127429,19.4007600396,12,0,0,
The Descendants,2143,20000000,82624961,175507800,62624961,155507800,66.8740304976,19.3988491175,19.3936023715,74,0,0,
Are We There Yet?,2144,20000000,82301521,97741594,62301521,77741594,66.8740304976,19.0529724048,19.3923790944,23,0,0,
School of Rock,2145,20000000,81261177,131945303,61261177,111945303,66.8740304976,19.2199680887,19.3884342483,57,0,0,
Disturbia,2146,20000000,80106701,117825354,60106701,97825354,66.8740304976,19.1543727415,19.384038335,66,0,0,
Mortal Kombat,2147,20000000,70423929,122123929,50423929,102123929,66.8740304976,19.1748015255,19.3463880009,41,0,0,
White Chicks,2148,20000000,69148997,111448997,49148997,91448997,66.8740304976,19.1232793141,19.3413232651,83,0,0,
Obsessed,2149,20000000,68261644,73964713,48261644,53964713,66.8740304976,18.9179040037,19.3377830065,84,0,0,
Holes,2150,20000000,67383924,71232214,47383924,51232214,66.8740304976,18.9011448215,19.3342688069,24,0,0,
Tyler Perry's Madea's Witness Protection,2151,20000000,65653242,65653242,45653242,45653242,66.8740304976,18.8660297043,19.3273031398,22,0,0,
The Last Song,2152,20000000,62950384,92678948,42950384,72678948,66.8740304976,19.0257024181,19.3163266504,10,0,0,
Why Did I Get Married Too?,2153,20000000,60095852,60831067,40095852,40831067,66.8740304976,18.8346516352,19.3046018798,33,0,0,
12 Years a Slave,2154,20000000,56671993,181025343,36671993,161025343,66.8740304976,19.419382767,19.2903548666,24,0,0,
Drumline,2155,20000000,56398162,56398162,36398162,36398162,66.8740304976,18.8049113474,19.2892066145,99,0,0,
Edward Scissorhands,2156,20000000,53976987,53976987,33976987,33976987,66.8740304976,18.7882863332,19.2789961506,43,0,0,
Selma,2157,20000000,52076908,66776908,32076908,46776908,66.8740304976,18.873202133,19.270909572,70,0,0,
Popeye,2158,20000000,49823037,49823037,29823037,29823037,66.8740304976,18.7591030708,19.2612317152,40,0,0,
Date Movie,2159,20000000,48548426,85146165,28548426,65146165,66.8740304976,18.9836987777,19.2557169379,61,0,0,
Peter Pan: Return to Neverland,2160,20000000,48423368,109855792,28423368,89855792,66.8740304976,19.115356925,19.2551742155,1,0,0,
The Jungle Book 2,2161,20000000,47901582,140122225,27901582,120122225,66.8740304976,19.2560757615,19.2529066031,79,0,0,
Premonition,2162,20000000,47852604,81461343,27852604,61461343,66.8740304976,18.962490862,19.252693487,27,0,0,
Boogeyman,2163,20000000,46363118,66803595,26363118,46803595,66.8740304976,18.8733718539,19.2461905551,50,0,0,
The Tigger Movie,2164,20000000,45542421,96147688,25542421,76147688,66.8740304976,19.0444667531,19.2425893301,51,0,0,
Max,2165,20000000,42656255,43553101,22656255,23553101,66.8740304976,18.7133753054,19.2298208077,5,0,0,
Meet the Browns,2166,20000000,41975388,41975388,21975388,21975388,66.8740304976,18.7015317629,19.2267847059,25,0,0,
Orphan,2167,20000000,41596251,78337373,21596251,58337373,66.8740304976,18.9441517666,19.2250900653,65,0,0,
Epic Movie,2168,20000000,39739367,86858578,19739367,66858578,66.8740304976,18.9934035161,19.2167485621,7,0,0,
Lakeview Terrace,2169,20000000,39263506,44821299,19263506,24821299,66.8740304976,18.7227947311,19.2145996493,68,0,0,
The Grudge 2,2170,20000000,39143839,70743839,19143839,50743839,66.8740304976,18.8981196691,19.2140585247,25,0,0,
Conan the Barbarian,2171,20000000,38264085,79114085,18264085,59114085,66.8740304976,18.9487429232,19.2100713324,31,0,0,
How Stella Got Her Groove Back,2172,20000000,37672350,37672350,17672350,17672350,66.8740304976,18.6684981136,19.2073805198,59,0,0,
Bill & Ted's Bogus Journey,2173,20000000,37537675,37537675,17537675,17537675,66.8740304976,18.6674464191,19.2067670957,13,0,0,
Man of the Year,2174,20000000,37442180,41342180,17442180,21342180,66.8740304976,18.6967386822,19.2063319025,60,0,0,
Vampires Suck,2175,20000000,36661504,81424988,16661504,61424988,66.8740304976,18.9622793646,19.2027670568,14,0,0,
The Black Hole,2176,20000000,35841901,35841901,15841901,15841901,66.8740304976,18.6541083764,19.1990107316,67,0,0,
The American,2177,20000000,35606376,67950723,15606376,47950723,66.8740304976,18.8806401296,19.197928681,15,0,0,
Selena,2178,20000000,35422828,35422828,15422828,15422828,66.8740304976,18.6507845763,19.1970846111,62,0,0,
A Very Harold & Kumar 3D Christmas,2179,20000000,35061031,36265745,15061031,16265745,66.8740304976,18.6574588174,19.1954187502,25,0,0,
Eternal Sunshine of the Spotless Mind,2180,20000000,34366518,73135439,14366518,53135439,66.8740304976,18.9128474539,19.1922131316,37,0,0,
Texas Chainsaw 3D,2181,20000000,34341945,47666013,14341945,27666013,66.8740304976,18.7436063161,19.1920995232,20,0,0,
Babel,2182,20000000,34302837,132121212,14302837,112121212,66.8740304976,19.2207587496,19.1919186884,30,0,0,
This is Where I Leave You,2183,20000000,34296320,41296320,14296320,21296320,66.8740304976,18.6963906502,19.1918885507,98,0,0,
Doubt,2184,20000000,33446470,53191101,13446470,33191101,66.8740304976,18.7828300771,19.1879506405,37,0,0,
Team America: World Police,2185,20000000,32774834,50274834,12774834,30274834,66.8740304976,18.7623187294,19.1848275046,35,0,0,
Scary Movie V,2186,20000000,32015787,78613981,12015787,58613981,66.8740304976,18.9457892185,19.181286123,46,0,0,
Copycat,2187,20000000,31925151,31925151,11925151,11925151,66.8740304976,18.6226038703,19.1808624157,68,0,0,
Milk,2188,20000000,31841299,57293371,11841299,37293371,66.8740304976,18.810988985,19.1804702624,80,0,0,
Paint Your Wagon,2189,20000000,31678778,31678778,11678778,11678778,66.8740304976,18.620588585,19.1797097571,15,0,0,
She's Out of My League,2190,20000000,31628317,48298434,11628317,28298434,66.8740304976,18.7481747683,19.1794735108,18,0,0,
The Debt,2191,20000000,31177548,46604054,11177548,26604054,66.8740304976,18.7358877265,19.1773606385,26,0,0,
Ghost Ship,2192,20000000,30113491,68349884,10113491,48349884,66.8740304976,18.8831569003,19.1723553464,66,0,0,
Daybreakers,2193,20000000,30101577,51445503,10101577,31445503,66.8740304976,18.7706031558,19.1722991613,8,0,0,
The Bank Job,2194,20000000,30060660,66143005,10060660,46143005,66.8740304976,18.869162218,19.172106177,42,0,0,
Wild Things,2195,20000000,29753944,55535344,9753944,35535344,66.8740304976,18.7990184488,19.1706583693,95,0,0,
The Stepfather,2196,20000000,29062561,29227561,9062561,9227561,66.8740304976,18.6003137148,19.1673870894,38,0,0,
High Fidelity,2197,20000000,27277055,47881663,7277055,27881663,66.8740304976,18.7451664642,19.1588891257,72,0,0,
Stick It,2198,20000000,26910736,30399714,6910736,10399714,66.8740304976,18.6100603011,19.1571366981,81,0,0,
One Missed Call,2199,20000000,26890041,44513466,6890041,24513466,66.8740304976,18.7205164707,19.1570376039,95,0,0,
Eye for an Eye,2200,20000000,26729447,26729447,6729447,6729447,66.8740304976,18.5792191181,19.1562682952,99,0,0,
Street Kings,2201,20000000,26415649,65454793,6415649,45454793,66.8740304976,18.8647576299,19.1547633686,88,0,0,
The World's End,2202,20000000,26004851,47508505,6004851,27508505,66.8740304976,18.7424652637,19.1527898158,18,0,0,
From Dusk Till Dawn,2203,20000000,25728961,25728961,5728961,5728961,66.8740304976,18.5706444105,19.1514621973,10,0,0,
You Again,2204,20000000,25702053,32838945,5702053,12838945,66.8740304976,18.6300432677,19.1513326181,8,0,0,
Alpha and Omega 3D,2205,20000000,25107267,48958353,5107267,28958353,66.8740304976,18.7529197116,19.1484640484,3,0,0,
Endless Love,2206,20000000,23438250,34614964,3438250,14614964,66.8740304976,18.6443458073,19.140370391,71,0,0,
The Covenant,2207,20000000,23342105,38142105,3342105,18142105,66.8740304976,18.672157858,19.1399021481,21,0,0,
Monte Carlo,2208,20000000,23186769,39686769,3186769,19686769,66.8740304976,18.6840983843,19.1391451713,38,0,0,
Stay Alive,2209,20000000,23086480,23187506,3086480,3187506,66.8740304976,18.5485262979,19.1386561426,51,0,0,
2 For the Money,2210,20000000,22862049,30362049,2862049,10362049,66.8740304976,18.6097485851,19.1375609061,48,0,0,
Quigley Down Under,2211,20000000,21413105,21413105,1413105,1413105,66.8740304976,18.5327885683,19.1304609556,60,0,0,
Psycho,2212,20000000,21380220,37065220,1380220,17065220,66.8740304976,18.6637481859,19.1302992297,51,0,0,
To Die For,2213,20000000,21016710,27420940,1016710,7420940,66.8740304976,18.5851029082,19.1285097718,43,0,0,
Shorts,2214,20000000,20919166,29870801,919166,9870801,66.8740304976,18.6056740868,19.1280290446,74,0,0,
Vampires,2215,20000000,20241395,20241395,241395,241395,66.8740304976,18.5222588484,19.1246823812,12,0,0,
Appaloosa,2216,20000000,20211394,27911453,211394,7911453,66.8740304976,18.5892557062,19.1245339846,72,0,0,
Yu-Gi-Oh,2217,20000000,19762690,28762690,-237310,8762690,66.8740304976,18.5964217967,19.1223118887,21,0,0,
Reign Over Me,2218,20000000,19661987,20081987,-338013,81987,66.8740304976,18.5208177016,19.1218125028,28,0,0,
My Best Friend's Girl,2219,20000000,19219250,34787111,-780750,14787111,66.8740304976,18.6457213189,19.1196140079,47,0,0,
Georgia Rule,2220,20000000,18882880,20819601,-1117120,819601,66.8740304976,18.5274688272,19.1179404615,89,0,0,
Under the Rainbow,2221,20000000,18826490,18826490,-1173510,-1173510,66.8740304976,18.5093940486,19.1176596292,87,0,0,
Into the Wild,2222,20000000,18354356,56822960,-1645644,36822960,66.8740304976,18.8077999369,19.1153052178,68,0,0,
Simon Birch,2223,20000000,18252684,18309860,-1747316,-1690140,66.8740304976,18.5046551157,19.1147974794,25,0,0,
Ladyhawke,2224,20000000,18248879,18248879,-1751121,-1751121,66.8740304976,18.5040942657,19.1147784726,94,0,0,
Pooh's Heffalump Movie,2225,20000000,18098433,52858433,-1901567,32858433,66.8740304976,18.7805114284,19.1140266748,88,0,0,
School for Scoundrels,2226,20000000,17807569,17807569,-2192431,-2192431,66.8740304976,18.5000260794,19.1125715857,57,0,0,
Silent Hill: Revelation 3D,2227,20000000,17530219,55975672,-2469781,35975672,66.8740304976,18.8020301521,19.1111821275,11,0,0,
Home for the Holidays,2228,20000000,17424349,22074731,-2575651,2074731,66.8740304976,18.5386857373,19.1106512342,15,0,0,
Fired Up,2229,20000000,17231291,18608570,-2768709,-1391430,66.8740304976,18.5073978544,19.1096824038,5,0,0,
Kung Fu Hustle,2230,20000000,17104669,102034104,-2895331,82034104,66.8740304976,19.075525389,19.1090464616,52,0,0,
The Country Bears,2231,20000000,16988996,16988996,-3011004,-3011004,66.8740304976,18.4924360179,19.1084651556,91,0,0,
21 Grams,2232,20000000,16248701,59667625,-3751299,39667625,66.8740304976,18.8269313236,19.1047368356,17,0,0,
Armored,2233,20000000,15988876,23661038,-4011124,3661038,66.8740304976,18.5526846707,19.1034249861,20,0,0,
The Kite Runner,2234,20000000,15800078,74180745,-4199922,54180745,66.8740304976,18.9192170849,19.1024706694,62,0,0,
Paparazzi,2235,20000000,15712072,16612072,-4287928,-3387928,66.8740304976,18.4889215968,19.1020255143,85,0,0,
A Guy Thing,2236,20000000,15543862,17430594,-4456138,-2569406,66.8740304976,18.4965378056,19.1011741168,2,0,0,
The Greatest Story Ever Told,2237,20000000,15473333,15473333,-4526667,-4526667,66.8740304976,18.4782284016,19.1008169173,12,0,0,
Loser,2238,20000000,15464026,18250106,-4535974,-1749894,66.8740304976,18.5041055537,19.1007697718,1,0,0,
Twilight,2239,20000000,15030732,15030732,-4969268,-4969268,66.8740304976,18.4740411535,19.0985724137,23,0,0,
Secret in Their Eyes,2240,20000000,15012671,18809832,-4987329,-1190168,66.8740304976,18.5092415983,19.0984807163,38,0,0,
Capitalism: A Love Story,2241,20000000,14363397,19121531,-5636603,-878469,66.8740304976,18.5120903538,19.0951786936,89,0,0,
Lockout,2242,20000000,14326865,33943049,-5673135,13943049,66.8740304976,18.638958806,19.0949925779,18,0,0,
Disaster Movie,2243,20000000,14190901,36720752,-5809099,16720752,66.8740304976,18.6610431484,19.0942995918,89,0,0,
What's Your Number?,2244,20000000,14011084,30163785,-5988916,10163785,66.8740304976,18.6081061457,19.0933823561,69,0,0,
The Man Who Knew Too Little,2245,20000000,13801755,13801755,-6198245,-6198245,66.8740304976,18.4623215744,19.0923135206,10,0,0,
Crank 2: High Voltage,2246,20000000,13684249,35472739,-6315751,15472739,66.8740304976,18.6511810162,19.091713033,100,0,0,
Burnt,2247,20000000,13550619,27290690,-6449381,7290690,66.8740304976,18.5839972774,19.091029709,23,0,0,
Envy,2248,20000000,13548322,14566246,-6451678,-5433754,66.8740304976,18.4696279245,19.0910179591,7,0,0,
One Night with the King,2249,20000000,13395961,13725032,-6604039,-6274968,66.8740304976,18.4615853656,19.0902382737,23,0,0,
Ghost Town,2250,20000000,13252641,29843245,-6747359,9843245,66.8740304976,18.6054450399,19.0895042991,79,0,0,
Bullets Over Broadway,2251,20000000,13202987,13202987,-6797013,-6797013,66.8740304976,18.4565615494,19.0892498839,91,0,0,
The Quiet American,2252,20000000,12987647,26348203,-7012353,6348203,66.8740304976,18.575960315,19.0881457836,4,0,0,
The Weather Man,2253,20000000,12482775,15466961,-7517225,-4533039,66.8740304976,18.4781682432,19.085552393,40,0,0,
Undisputed,2254,20000000,12398628,12398628,-7601372,-7601372,66.8740304976,18.4487711872,19.085119498,46,0,0,
12 Rounds,2255,20000000,12234694,17306648,-7765306,-2693352,66.8740304976,18.4953882293,19.0842755996,34,0,0,
Let Me In,2256,20000000,12134935,28270399,-7865065,8270399,66.8740304976,18.5922837367,19.083761712,49,0,0,
3 Ninjas Kick Back,2257,20000000,11744960,11744960,-8255040,-8255040,66.8740304976,18.4423952876,19.0817502999,98,0,0,
Be Kind Rewind,2258,20000000,11175164,30894247,-8824836,10894247,66.8740304976,18.6141440751,19.0788041141,1,0,0,
Mrs. Henderson Presents,2259,20000000,11036366,27836366,-8963634,7836366,66.8740304976,18.5886211189,19.0780851288,22,0,0,
Three to Tango,2260,20000000,10570375,10570375,-9429625,-9429625,66.8740304976,18.4308351828,19.0756674683,29,0,0,
Deconstructing Harry,2261,20000000,10569071,10569071,-9430929,-9430929,66.8740304976,18.4308222744,19.0756606947,80,0,0,
We're No Angels,2262,20000000,10555348,10555348,-9444652,-9444652,66.8740304976,18.4306864199,19.0755894077,75,0,0,
Everyone Says I Love You,2263,20000000,9714482,34588635,-10285518,14588635,66.8740304976,18.644135263,19.0712116285,31,0,0,
Death Sentence,2264,20000000,9534258,16907831,-10465742,-3092169,66.8740304976,18.4916802822,19.0702708337,90,0,0,
Everybody's Fine,2265,20000000,9208876,9208876,-10791124,-10791124,66.8740304976,18.4172661008,19.0685700488,99,0,0,
Super Babies: Baby Geniuses 2,2266,20000000,9109322,9355369,-10890678,-10644631,66.8740304976,18.4187349622,19.0680490975,11,0,0,
Battle of the Year,2267,20000000,8888355,16723377,-11111645,-3276623,66.8740304976,18.489960685,19.0668918395,53,0,0,
Death at a Funeral,2268,20000000,8580428,46790428,-11419572,26790428,66.8740304976,18.737246658,19.065276914,48,0,0,
The Man,2269,20000000,8330720,10393696,-11669280,-9606304,66.8740304976,18.4290847116,19.0639654009,41,0,0,
Code Name: The Cleaner,2270,20000000,8135024,8135024,-11864976,-11864976,66.8740304976,18.4064323765,19.0629363653,35,0,0,
Inherent Vice,2271,20000000,8110975,8692898,-11889025,-11307102,66.8740304976,18.4120752225,19.0628098344,42,0,0,
Connie & Carla,2272,20000000,8047525,8047525,-11952475,-11952475,66.8740304976,18.4055444359,19.0624759232,49,0,0,
Machete Kills,2273,20000000,8008161,18273009,-11991839,-1726991,66.8740304976,18.50431623,19.0622687106,3,0,0,
Sweet Charity,2274,20000000,8000000,8000000,-12000000,-12000000,66.8740304976,18.4050618212,19.0622257456,20,0,0,
Doogal,2275,20000000,7578946,28058652,-12421054,8058652,66.8740304976,18.5904985707,19.0600065267,95,0,0,
Proof,2276,20000000,7535331,8284331,-12464669,-11715669,66.8740304976,18.4079457269,19.0597763665,5,0,0,
An American Carol,2277,20000000,7008265,7017257,-12991735,-12982743,66.8740304976,18.3950295369,19.0569907968,45,0,0,
Willard,2278,20000000,6882696,6882696,-13117304,-13117304,66.8740304976,18.39364801,19.0563260123,6,0,0,
Strange Wilderness,2279,20000000,6575282,6947084,-13424718,-13052916,66.8740304976,18.3943093145,19.0546966406,14,0,0,
Little Boy,2280,20000000,6485961,7826546,-13514039,-12173454,66.8740304976,18.4032984231,19.0542227186,3,0,0,
Topsy Turvy,2281,20000000,6201757,6201757,-13798243,-13798243,66.8740304976,18.3866274464,19.0527132846,9,0,0,
Chasing Mavericks,2282,20000000,6002756,8300821,-13997244,-11699179,66.8740304976,18.4081127263,19.0516550138,66,0,0,
A Most Violent Year,2283,20000000,5749134,6071433,-14250866,-13928567,66.8740304976,18.3852781526,19.0503046479,96,0,0,
A Dangerous Method,2284,20000000,5702083,14807531,-14297917,-5192469,66.8740304976,18.4719228806,19.0500539324,39,0,0,
A Scanner Darkly,2285,20000000,5501616,7405084,-14498384,-12594916,66.8740304976,18.3990006807,19.0489850211,88,0,0,
Bandslam,2286,20000000,5210988,12967829,-14789012,-7032171,66.8740304976,18.4542902728,19.04743333,54,0,0,
Alone in the Dark,2287,20000000,5132655,8132655,-14867345,-11867345,66.8740304976,18.4064083462,19.0470146902,38,0,0,
Birth,2288,20000000,5005899,14603001,-14994101,-5396999,66.8740304976,18.4699778559,19.046336889,100,0,0,
Passchendaele,2289,20000000,4452423,4453327,-15547577,-15546673,66.8740304976,18.368371871,19.0433718975,32,0,0,
Flash of Genius,2290,20000000,4295905,4357639,-15704095,-15642361,66.8740304976,18.3673630968,19.0425318277,14,0,0,
I'm Not There,2291,20000000,4017609,12397613,-15982391,-7602387,66.8740304976,18.4487613183,19.0410364009,79,0,0,
The Cold Light of Day,2292,20000000,3763583,12425385,-16236417,-7574615,66.8740304976,18.4490313118,19.0396694342,28,0,0,
The Brothers Bloom,2293,20000000,3531756,5531756,-16468244,-14468244,66.8740304976,18.3796712111,19.0384202921,70,0,0,
"Synecdoche, New York",2294,20000000,3083538,4383538,-16916462,-15616462,66.8740304976,18.367636233,19.036000747,39,0,0,
Mononoke-hime,2295,20000000,2374107,150350000,-17625893,130350000,66.8740304976,19.2994782764,19.0321591305,30,0,0,
Bon Voyage,2296,20000000,2353728,8361736,-17646272,-11638264,66.8740304976,18.4087293903,19.0320485585,32,0,0,
My All-American,2297,20000000,2246000,2246000,-17754000,-17754000,66.8740304976,18.3448384904,19.0314638467,90,0,0,
Can't Stop the Music,2298,20000000,2000000,2000000,-18000000,-18000000,66.8740304976,18.3421811335,19.0301273572,32,0,0,
The Proposition,2299,20000000,1903434,5313608,-18096566,-14686392,66.8740304976,18.3773958232,19.0296022367,76,0,0,
Marci X,2300,20000000,1646664,1646664,-18353336,-18353336,66.8740304976,18.3383519069,19.0282045929,20,0,0,
Equilibrium,2301,20000000,1190018,5345869,-18809982,-14654131,66.8740304976,18.3777326472,19.0257141529,64,0,0,
Dylan Dog: Dead of Night,2302,20000000,1186538,6093725,-18813462,-13906275,66.8740304976,18.3855090792,19.02569515,64,0,0,
The Oogieloves in the BIG Balloon Adventure,2303,20000000,1065907,1065907,-18934093,-18934093,66.8740304976,18.3320260066,19.0250362073,83,0,0,
The Children of Huang Shi,2304,20000000,1031872,8221700,-18968128,-11778300,66.8740304976,18.4073111885,19.0248502138,58,0,0,
The Yards,2305,20000000,882710,2282710,-19117290,-17717290,66.8740304976,18.3452344367,19.024034669,73,0,0,
All Good Things,2306,20000000,582024,645024,-19417976,-19354976,66.8740304976,18.3274163961,19.0223886407,30,0,0,
By the Sea,2307,20000000,508989,1533770,-19491011,-18466230,66.8740304976,18.3371253374,19.02198842,41,0,0,
Steamboy,2308,20000000,468867,10468867,-19531133,-9531133,66.8740304976,18.429829853,19.0217684894,1,0,0,
The Game of Their Lives,2309,20000000,375474,375474,-19624526,-19624526,66.8740304976,18.3244530194,19.0212563638,48,0,0,
Rapa Nui,2310,20000000,305070,305070,-19694930,-19694930,66.8740304976,18.3236775639,19.0208701262,80,0,0,
The Tempest,2311,20000000,277943,277943,-19722057,-19722057,66.8740304976,18.3233786166,19.0207212672,72,0,0,
CJ7,2312,20000000,206678,47300771,-19793322,27300771,66.8740304976,18.7409583599,19.020330096,73,0,0,
"Couloirs du temps: Les visiteurs 2, Les",2313,20000000,146072,26146072,-19853928,6146072,66.8740304976,18.5742282191,19.0199973112,46,0,0,
People I Know,2314,20000000,121972,5694213,-19878028,-14305787,66.8740304976,18.3813623581,19.0198649484,44,0,0,
Der Baader Meinhof Komplex,2327,19700000,476270,16498827,-19223730,-3201173,66.6218297875,18.4906644352,19.0234523003,41,0,0,
The Painted Veil,2328,19400000,8060487,15118795,-11339513,-4281205,66.3667319454,18.4805430707,19.065697035,58,0,0,
The Devil's Double,2330,19100000,1361512,2406666,-17738488,-16693334,66.1086581068,18.3562159055,19.0315480617,89,0,0,
Back to the Future,2331,19000000,212259762,385524862,193259762,366524862,66.0219580408,19.9829748546,19.7949052642,53,0,0,
Dances with Wolves,2332,19000000,175293948,415285106,156293948,396285106,66.0219580408,20.0434994292,19.6967005045,37,0,0,
Scary Movie,2333,19000000,157019771,277200000,138019771,258200000,66.0219580408,19.7253588989,19.6443417338,64,0,0,
Bad Teacher,2334,19000000,100292856,215448997,81292856,196448997,66.0219580408,19.54203004,19.461784594,84,0,0,
Just Married,2335,19000000,56127162,101564935,37127162,82564935,66.0219580408,19.0782793811,19.2922606086,64,0,0,
Sea of Love,2336,19000000,53350495,53350495,34350495,34350495,66.0219580408,18.7908691278,19.2805781077,8,0,0,
I Can Do Bad All By Myself,2337,19000000,51733921,51733921,32733921,32733921,66.0219580408,18.7796422129,19.2737131674,14,0,0,
A Cinderella Story,2338,19000000,51438175,70164105,32438175,51164105,66.0219580408,18.9007234811,19.2724521375,88,0,0,
The Shining,2339,19000000,44017374,44414369,25017374,25414369,66.0219580408,18.7271694406,19.2402785986,68,0,0,
Thirteen Ghosts,2340,19000000,41867960,68467960,22867960,49467960,66.0219580408,18.890173005,19.2307629608,90,0,0,
House on Haunted Hill,2341,19000000,40846082,65090541,21846082,46090541,66.0219580408,18.8688271283,19.2262070654,12,0,0,
The Crazies,2342,19000000,39123589,56445534,20123589,37445534,66.0219580408,18.8120183675,19.2184802845,32,0,0,
The Switch,2344,19000000,27758465,49858465,8758465,30858465,66.0219580408,18.7664574665,19.1659448632,88,0,0,
Leap Year,2345,19000000,25918920,32618920,6918920,13618920,66.0219580408,18.6363497262,19.1571758829,72,0,0,
The Book Thief,2346,19000000,21488481,76086711,2488481,57086711,66.0219580408,18.9367144999,19.1357352081,64,0,0,
"Gone, Baby, Gone",2347,19000000,20300218,34352162,1300218,15352162,66.0219580408,18.6502230118,19.129905677,8,0,0,
Thomas and the Magic Railroad,2348,19000000,15911332,15911332,-3088668,-3088668,66.0219580408,18.4917128921,19.1080746713,4,0,0,
Mutiny on The Bounty,2349,19000000,13680000,13680000,-5320000,-5320000,66.0219580408,18.4707105396,19.0967902085,11,0,0,
Sen to Chihiro no Kamikakushi,2350,19000000,10049886,274949886,-8950114,255949886,66.0219580408,19.7192365401,19.0781551863,53,0,0,
Sex Drive,2351,19000000,8402485,10412485,-10597515,-8587515,66.0219580408,18.4391366512,19.0695823994,13,0,0,
Firestorm,2352,19000000,8041665,8041665,-10958335,-10958335,66.0219580408,18.4155868622,19.0676949036,9,0,0,
Take Me Home Tonight,2353,19000000,6928068,7576604,-12071932,-11423396,66.0219580408,18.4109015432,19.0618469675,18,0,0,
Won't Back Down,2354,19000000,5310554,5431486,-13689446,-13568514,66.0219580408,18.3890014937,19.0532913848,15,0,0,
The Fall of the Roman Empire,2355,19000000,4750000,4750000,-14250000,-14250000,66.0219580408,18.3819424313,19.0503092619,74,0,0,
The Nutcracker,2356,19000000,2119994,2119994,-16880006,-16880006,66.0219580408,18.3542228995,19.0361977606,77,0,0,
Kansas City,2357,19000000,1353824,1353824,-17646176,-17646176,66.0219580408,18.3460010116,19.0320490794,97,0,0,
George A. Romero's Land of the Dead,2359,18975000,20433940,47484873,1458940,28509873,66.0002295672,18.7496975075,19.1306863248,98,0,0,
Indigènes,2360,18900000,320700,26063572,-18579300,7163572,65.9349150591,18.5829170526,19.0269730135,36,0,0,
The Amityville Horror,2361,18500000,64858000,108800304,46358000,90300304,65.5832496414,19.1175736306,19.3301455159,46,0,0,
Adaptation,2362,18500000,22498520,22498520,3998520,3998520,65.5832496414,18.5556377874,19.1430946502,32,0,0,
The Invention of Lying,2363,18500000,18451251,32679264,-48749,14179264,65.5832496414,18.6408559421,19.1232462922,16,0,0,
Fear and Loathing in Las Vegas,2364,18500000,10562387,13594015,-7937613,-4905985,65.5832496414,18.4746409206,19.0833878303,88,0,0,
Ne le dis à personne,2365,18500000,6198883,33954018,-12301117,15454018,65.5832496414,18.6510323349,19.0606391718,18,0,0,
Neighbors,2367,18000000,150086800,270594534,132086800,252594534,65.1355562433,19.7100367345,19.626735742,29,0,0,
Borat,2368,18000000,128505958,261443242,110505958,243443242,65.1355562433,19.6845065332,19.5599463057,54,0,0,
The Mask,2369,18000000,119874149,351574149,101874149,333574149,65.1355562433,19.9113900536,19.5319310685,74,0,0,
Big,2370,18000000,113327971,150027971,95327971,132027971,65.1355562433,19.306422421,19.5101489931,83,0,0,
Legally Blonde,2371,18000000,96493426,141809235,78493426,123809235,65.1355562433,19.2719399351,19.4518516249,35,0,0,
Mean Girls,2372,18000000,86047227,130953026,68047227,112953026,65.1355562433,19.224489073,19.4138901013,28,0,0,
The Exorcism of Emily Rose,2373,18000000,75072454,144529078,57072454,126529078,65.1355562433,19.283483438,19.3723918036,37,0,0,
Star Trek III: The Search for Spock,2374,18000000,71273785,81802739,53273785,63802739,65.1355562433,18.9760187151,19.3576173005,13,0,0,
Deuce Bigalow: Male Gigolo,2375,18000000,65535067,92935067,47535067,74935067,65.1355562433,19.0379469685,19.3348748314,43,0,0,
Barbershop 2: Back in Business,2376,18000000,65070412,65842412,47070412,47842412,65.1355562433,18.8799561183,19.3330105738,45,0,0,
The Family Stone,2377,18000000,60062868,92357499,42062868,74357499,65.1355562433,19.0348266049,19.3126959512,9,0,0,
Bad Santa,2378,18000000,60060328,77147031,42060328,59147031,65.1355562433,18.9489372022,19.3126855415,94,0,0,
Predator,2379,18000000,56072497,94604507,38072497,76604507,65.1355562433,19.0469119074,19.2962070547,35,0,0,
Austin Powers: International Man of Mystery,2380,18000000,53868030,67668030,35868030,49668030,65.1355562433,18.8914233002,19.2869798645,80,0,0,
Diary of a Wimpy Kid: Rodrick Rules,2381,18000000,52698535,73695194,34698535,55695194,65.1355562433,18.9283740833,19.2820499484,25,0,0,
Amadeus,2382,18000000,51564280,51564280,33564280,33564280,65.1355562433,18.7854246997,19.2772452546,59,0,0,
Prom Night,2383,18000000,43869350,57193655,25869350,39193655,65.1355562433,18.8237690097,19.2440254516,29,0,0,
Soul Surfer,2384,18000000,43853424,47158652,25853424,29158652,65.1355562433,18.7543554569,19.2439555403,1,0,0,
Under the Tuscan Sun,2385,18000000,43601508,57490024,25601508,39490024,65.1355562433,18.8257475461,19.242849038,4,0,0,
Birdman or (The Unexpected Virtue of Ignorance),2386,18000000,42340598,103240598,24340598,85240598,65.1355562433,19.092046625,19.2372922091,55,0,0,
Gosford Park,2387,18000000,41300105,41300105,23300105,23300105,65.1355562433,18.7114855382,19.2326833894,41,0,0,
Orange County,2388,18000000,41059716,43308707,23059716,25308707,65.1355562433,18.7263914373,19.2316155691,79,0,0,
Peggy Sue Got Married,2389,18000000,38948832,38948832,20948832,20948832,65.1355562433,18.6937496169,19.2221896207,83,0,0,
Blue Jasmine,2390,18000000,33404871,102912961,15404871,84912961,65.1355562433,19.0903709636,19.1970019952,15,0,0,
United 93,2391,18000000,31483450,77551351,13483450,59551351,65.1355562433,18.9513183656,19.1881223161,72,0,0,
Honey,2392,18000000,30272254,62646763,12272254,44646763,65.1355562433,18.8595613179,19.1824840894,51,0,0,
Spy Hard,2394,18000000,26906039,26906039,8906039,8906039,65.1355562433,18.5976235362,19.1666450174,5,0,0,
Glory,2395,18000000,26593580,26593580,8593580,8593580,65.1355562433,18.5950022355,19.1651619979,81,0,0,
Conan the Destroyer,2396,18000000,26365298,26365298,8365298,8365298,65.1355562433,18.5930827645,19.1640771143,37,0,0,
Catch-22,2397,18000000,24911670,24911670,6911670,6911670,65.1355562433,18.5807729835,19.1571411701,29,0,0,
Observe and Report,2398,18000000,24007324,27148898,6007324,9148898,65.1355562433,18.5996562089,19.1528017082,4,0,0,
Raging Bull,2399,18000000,23380203,23380203,5380203,5380203,65.1355562433,18.5676379988,19.1497814023,50,0,0,
Love Happens,2400,18000000,22965110,36133014,4965110,18133014,65.1355562433,18.6720871592,19.1477772249,72,0,0,
Fame,2401,18000000,22455510,80227619,4455510,62227619,65.1355562433,18.9669383416,19.1453112378,12,0,0,
Love the Coopers,2402,18000000,21028459,21879368,3028459,3879368,65.1355562433,18.5545961504,19.1383731117,62,0,0,
127 Hours,2403,18000000,18335230,60217171,335230,42217171,65.1355562433,18.8437723421,19.1251463835,35,0,0,
Young Sherlock Holmes,2404,18000000,18106539,18106539,106539,106539,65.1355562433,18.5210398022,19.124015158,99,0,0,
Center Stage,2405,18000000,17200925,21361109,-799075,3361109,65.1355562433,18.5500528199,19.1195229073,7,0,0,
Small Time Crooks,2406,18000000,17071230,29739348,-928770,11739348,65.1355562433,18.6210844129,19.1188779069,20,0,0,
Catch That Kid,2407,18000000,16703799,16959614,-1296201,-1040386,65.1355562433,18.5106115354,19.1170483335,61,0,0,
Jobs,2408,18000000,16131410,26131410,-1868590,8131410,65.1355562433,18.5911123278,19.1141915135,36,0,0,
Life as a House,2409,18000000,15652637,23889158,-2347363,5889158,65.1355562433,18.5720223392,19.1117956509,90,0,0,
Youth in Revolt,2410,18000000,15285588,19685588,-2714412,1685588,65.1355562433,18.5352214624,19.1099549794,85,0,0,
And So It Goes,2411,18000000,15160801,17360801,-2839199,-639199,65.1355562433,18.5142716558,19.109328427,0,0,0,
"I Love You, Beth Cooper",2412,18000000,14800725,16382538,-3199275,-1617462,65.1355562433,18.5053231339,19.1075182906,89,0,0,
Blow Out,2413,18000000,13747234,13747234,-4252766,-4252766,65.1355562433,18.4808109001,19.1022033958,68,0,0,
Tailor of Panama,2414,18000000,13491653,27491653,-4508347,9491653,65.1355562433,18.6025179752,19.1009097126,10,0,0,
The Legend of the Lone Ranger,2415,18000000,13400000,13400000,-4600000,-4600000,65.1355562433,18.4775358419,19.1004453815,80,0,0,
Labor Day,2416,18000000,13371528,13371528,-4628472,-4628472,65.1355562433,18.4772668219,19.1003010931,33,0,0,
Getaway,2417,18000000,10501938,11813989,-7498062,-6186011,65.1355562433,18.4624389178,19.085650951,42,0,0,
The Ice Storm,2418,18000000,7837632,15811546,-10162368,-2188454,65.1355562433,18.5000628151,19.0718539803,55,0,0,
Being Julia,2419,18000000,7739049,14488705,-10260951,-3511295,65.1355562433,18.4877686409,19.0713398032,4,0,0,
Troop Beverly Hills,2420,18000000,7190505,7190505,-10809495,-10809495,65.1355562433,18.4170817454,19.0684739365,0,0,0,
Nine 1/2 Weeks,2421,18000000,6734844,6734844,-11265156,-11265156,65.1355562433,18.4124982183,19.0660870759,30,0,0,
The Last Station,2422,18000000,6617867,15696146,-11382133,-2303854,65.1355562433,18.4989963118,19.0654734025,48,0,0,
Dragonslayer,2423,18000000,5939000,5939000,-12061000,-12061000,65.1355562433,18.4044420269,19.0619045422,67,0,0,
Ed Wood,2424,18000000,5755976,5755976,-12244024,-12244024,65.1355562433,18.4025800912,19.060940186,29,0,0,
Mongol,2425,18000000,5705761,27147349,-12294239,9147349,65.1355562433,18.5996432572,19.0606754398,100,0,0,
RocknRolla,2426,18000000,5700626,27794339,-12299374,9794339,65.1355562433,18.6050384016,19.0606483628,42,0,0,
Megaforce,2427,18000000,5675599,5675599,-12324401,-12324401,65.1355562433,18.4017613048,19.0605163844,35,0,0,
Mao's Last Dancer,2428,18000000,4806750,12949849,-13193250,-5050151,65.1355562433,18.4732740575,19.0559237262,51,0,0,
The Railway Man,2429,18000000,4438438,23910210,-13561562,5910210,65.1355562433,18.5722032762,19.0539704781,78,0,0,
Restoration,2431,18000000,3901738,3901738,-14098262,-14098262,65.1355562433,18.3835185028,19.0511173797,14,0,0,
Metallica Through the Never,2432,18000000,3419967,9082906,-14580033,-8917094,65.1355562433,18.4358958845,19.0485493323,10,0,0,
Anything Else,2433,18000000,3203044,13203044,-14796956,-4796956,65.1355562433,18.4756734043,19.0473908824,37,0,0,
Unforgettable,2434,18000000,2483790,2483790,-15516210,-15516210,65.1355562433,18.3686928085,19.0435401669,66,0,0,
Das Weisse Band: Eine deutsche Kindergeschichte,2435,18000000,2222862,25727044,-15777138,7727044,65.1355562433,18.5876964787,19.0421395467,59,0,0,
Phantom,2436,18000000,1034589,1186703,-16965411,-16813297,65.1355562433,18.3549355752,19.0357361584,74,0,0,
The Salton Sea,2437,18000000,676698,676698,-17323302,-17323302,65.1355562433,18.3494740668,19.0337994864,50,0,0,
The Informers,2438,18000000,315000,315000,-17685000,-17685000,65.1355562433,18.3455825803,19.0318383951,88,0,0,
One Man's Hero,2439,18000000,229311,229311,-17770689,-17770689,65.1355562433,18.3446584346,19.0313732337,30,0,0,
Carlos,2440,18000000,145526,145526,-17854474,-17854474,65.1355562433,18.3437539967,19.0309181988,35,0,0,
Renaissance,2441,18000000,70644,2401413,-17929356,-15598587,65.1355562433,18.3678247029,19.0305113407,11,0,0,
Red Sonja,2448,17900000,6905861,6905861,-10994139,-10994139,65.0449011089,18.415226929,19.0675074138,88,0,0,
Red Lights,2449,17700000,49521,14518884,-17650479,-3181116,64.8624451712,18.490851431,19.0320257307,83,0,0,
Superbad,2450,17500000,121463226,169955142,103963226,152455142,64.6784363808,19.3873047688,19.5387836734,85,0,0,
Madea Goes To Jail,2451,17500000,90508336,90508336,73008336,73008336,64.6784363808,19.0274994671,19.4320985735,7,0,0,
Step Up 2 the Streets,2452,17500000,58017783,148586910,40517783,131086910,64.6784363808,19.3025338578,19.3063436109,91,0,0,
Hoodwinked,2453,17500000,51221667,109678446,33721667,92178446,64.6784363808,19.126885739,19.2779133255,26,0,0,
Hitman,2454,17500000,39687694,99135571,22187694,81635571,64.6784363808,19.0734527729,19.2277324039,100,0,0,
Hotel Rwanda,2455,17500000,23519128,36521223,6019128,19021223,64.6784363808,18.6789710674,19.1528584706,64,0,0,
Beerfest,2456,17500000,19185184,20159316,1685184,2659316,64.6784363808,18.5438674469,19.1317980159,91,0,0,
Black Nativity,2457,17500000,7018188,7285135,-10481812,-10214865,64.6784363808,18.4230317483,19.070186903,82,0,0,
City of Ghosts,2458,17500000,325491,325491,-17174509,-17174509,64.6784363808,18.3510705356,19.0346051124,75,0,0,
The Others,2459,17000000,96522687,207765056,79522687,190765056,64.2114135152,19.5233358428,19.4555151395,87,0,0,
Aliens,2460,17000000,85160248,183316455,68160248,166316455,64.2114135152,19.4386854602,19.4143086277,46,0,0,
Lets Be Cops,2461,17000000,82390774,136890774,65390774,119890774,64.2114135152,19.2550714471,19.404002245,39,0,0,
I Know What You Did Last Summer,2462,17000000,72219395,125219395,55219395,108219395,64.2114135152,19.203072642,19.3652118015,66,0,0,
My Fair Lady,2463,17000000,72000000,72000000,55000000,55000000,64.2114135152,18.9241810551,19.3643582939,39,0,0,
Sideways,2464,17000000,71502303,109793192,54502303,92793192,64.2114135152,19.1299150009,19.362419409,62,0,0,
The Best Man Holiday,2465,17000000,70525195,72835710,53525195,55835710,64.2114135152,18.9292194668,19.3586019062,28,0,0,
Pitch Perfect,2467,17000000,65001093,116044347,48001093,99044347,64.2114135152,19.1602084689,19.3367411053,51,0,0,
Halloween: H2O,2468,17000000,55004135,55004135,38004135,38004135,64.2114135152,18.8157882435,19.2959221889,7,0,0,
Evil Dead,2469,17000000,54239856,97778356,37239856,80778356,64.2114135152,19.0689801186,19.2927318855,3,0,0,
Jet Li's Hero,2470,17000000,53652140,177535958,36652140,160535958,64.2114135152,19.4175784551,19.2902716616,95,0,0,
Saw 3D,2471,17000000,45710178,133735284,28710178,116735284,64.2114135152,19.2412775368,19.256418467,27,0,0,
"McFarland, USA",2472,17000000,44480275,44633422,27480275,27633422,64.2114135152,18.7433703204,19.2510718995,10,0,0,
The Hills Have Eyes,2473,17000000,41778863,70355813,24778863,53355813,64.2114135152,18.9141936946,19.2392271455,98,0,0,
40 Days and 40 Nights,2474,17000000,37939782,95092667,20939782,78092667,64.2114135152,19.054836173,19.2221490169,13,0,0,
Good Boy!,2475,17000000,37654781,45299252,20654781,28299252,64.2114135152,18.7481806638,19.2208694855,28,0,0,
Smokin' Aces,2476,17000000,35662731,57263440,18662731,40263440,64.2114135152,18.8308924492,19.2118800327,3,0,0,
A Night at the Roxbury,2477,17000000,30324946,30324946,13324946,13324946,64.2114135152,18.6339774782,19.1873862711,42,0,0,
Beastly,2478,17000000,27865571,38028230,10865571,21028230,64.2114135152,18.6943536852,19.1758957022,68,0,0,
Brooklyn's Finest,2479,17000000,27163593,39233233,10163593,22233233,64.2114135152,18.7034769626,19.1725915876,31,0,0,
Tron,2480,17000000,26918576,26918576,9918576,9918576,64.2114135152,18.6060710707,19.171435751,62,0,0,
Lottery Ticket,2481,17000000,24719879,24719879,7719879,7719879,64.2114135152,18.5876358476,19.1610034526,56,0,0,
Dickie Roberts: Former Child Star,2482,17000000,22734486,23734486,5734486,6734486,64.2114135152,18.5792621195,19.1514888016,51,0,0,
ATL,2483,17000000,21170563,21170563,4170563,4170563,64.2114135152,18.5571398904,19.1439297056,78,0,0,
Summer Catch,2484,17000000,19693891,19693891,2693891,2693891,64.2114135152,18.5441730773,19.1367394984,65,0,0,
A Simple Plan,2485,17000000,16311763,16311763,-688237,-688237,64.2114135152,18.513824989,19.1200737984,22,0,0,
Larry the Cable Guy: Health Inspector,2486,17000000,15680099,15680099,-1319901,-1319901,64.2114135152,18.5080535149,19.1169302075,20,0,0,
Wes Craven Presents: They,2487,17000000,12840842,16140842,-4159158,-859158,64.2114135152,18.5122665789,19.1026767962,89,0,0,
The Adventures of Elmo in Grouchland,2488,17000000,11634458,11634458,-5365542,-5365542,64.2114135152,18.4702772497,19.0965585587,85,0,0,
Superman IV: The Quest for Peace,2489,17000000,11227824,11227824,-5772176,-5772176,64.2114135152,18.4664001602,19.0944878298,48,0,0,
55 Days at Peking,2490,17000000,10000000,10000000,-7000000,-7000000,64.2114135152,18.4546013015,19.0882091533,2,0,0,
My Life in Ruins,2491,17000000,8665206,20465206,-8334794,3465206,64.2114135152,18.5509670471,19.0813384461,26,0,0,
American Dreamz,2492,17000000,7156725,16353669,-9843275,-646331,64.2114135152,18.5142067058,19.073516456,96,0,0,
How She Move,2493,17000000,7070641,8607815,-9929359,-8392185,64.2114135152,18.4410523957,19.0730682302,23,0,0,
Running Scared,2494,17000000,6855137,8345277,-10144863,-8654723,64.2114135152,18.4384766435,19.0719452531,58,0,0,
The Apparition,2495,17000000,4936819,6909667,-12063181,-10090333,64.2114135152,18.4242733728,19.061893056,47,0,0,
Bobby Jones: Stroke of Genius,2496,17000000,2694071,2694071,-14305929,-14305929,64.2114135152,18.3813608812,19.0500112335,55,0,0,
Shanghai Surprise,2497,17000000,2315000,2315000,-14685000,-14685000,64.2114135152,18.3774103588,19.0479889369,24,0,0,
L'illusionniste,2498,17000000,2231474,5631474,-14768526,-11368526,64.2114135152,18.4114554819,19.0475427856,79,0,0,
Roar,2499,17000000,2110050,2110050,-14889950,-14889950,64.2114135152,18.3752679362,19.0468938484,84,0,0,
Veronica Guerin,2500,17000000,1569918,9438074,-15430082,-7561926,64.2114135152,18.4491546473,19.044002058,30,0,0,
Southland Tales,2501,17000000,275380,364607,-16724620,-16635393,64.2114135152,18.3568337065,19.0370370544,35,0,0,
Escobar: Paradise Lost,2502,17000000,195792,766112,-16804208,-16233888,64.2114135152,18.3611043339,19.0366072599,9,0,0,
FUR: An Imaginary Portrait of Diane Arbus,2505,16800000,223202,2281089,-16576798,-14518911,64.0217174589,18.3791431915,19.037834839,29,0,0,
My Girl,2506,16500000,58011485,58011485,41511485,41511485,63.733972121,18.8391392511,19.3104336665,69,0,0,
Wall Street,2507,16500000,43848100,43848100,27348100,27348100,63.733972121,18.7413018846,19.2504956107,37,0,0,
Sense and Sensibility,2508,16500000,42975897,134975897,26475897,118475897,63.733972121,19.2489099724,19.2466844182,94,0,0,
The Illusionist,2509,16500000,39868642,83792062,23368642,67292062,63.733972121,18.995845329,19.2329876255,63,0,0,
Becoming Jane,2510,16500000,18663911,39380876,2163911,22880876,63.733972121,18.7083462013,19.134146262,20,0,0,
House of Sand and Fog,2511,16500000,13005485,16157923,-3494515,-342077,63.733972121,18.5169737589,19.1060316424,36,0,0,
Sydney White,2512,16500000,11702090,13446014,-4797910,-3053986,63.733972121,18.4920358792,19.0994419965,41,0,0,
Dead Poets' Society,2514,16400000,94326915,237966799,77926915,221566799,63.6371852478,19.6206968539,19.4498294647,68,0,0,
Dumb & Dumber,2515,16000000,127140750,246365376,111140750,230365376,63.2455532034,19.6468521794,19.5619759218,54,0,0,
When Harry Met Sally,2516,16000000,91744616,91744616,75744616,75744616,63.2455532034,19.042304307,19.4420013101,33,0,0,
Road Trip,2517,16000000,68525609,119739110,52525609,103739110,63.2455532034,19.1823710042,19.3546814445,80,0,0,
The Verdict,2518,16000000,53977250,53977250,37977250,37977250,63.2455532034,18.8156071277,19.2958101363,21,0,0,
Varsity Blues,2519,16000000,52894169,54294169,36894169,38294169,63.2455532034,18.8177400286,19.2912855466,87,0,0,
Moonrise Kingdom,2520,16000000,45512466,67503425,29512466,51503425,63.2455532034,18.9028208462,19.2598907874,10,0,0,
The Artist,2521,16000000,44667095,128256712,28667095,112256712,63.2455532034,19.2213673576,19.2562316613,2,0,0,
The Unborn,2522,16000000,42670410,78208812,26670410,62208812,63.2455532034,18.9668294218,19.2475356248,26,0,0,
The Master of Disguise,2523,16000000,40363530,40363530,24363530,24363530,63.2455532034,18.7194049175,19.2373935466,45,0,0,
The Texas Chainsaw Massacre: The Beginning,2524,16000000,39517763,50517763,23517763,34517763,63.2455532034,18.7920236209,19.2336492548,29,0,0,
El Laberinto del Fauno,2525,16000000,37634615,87041569,21634615,71041569,63.2455532034,19.0167210922,19.2252616727,41,0,0,
The Roommate,2526,16000000,37300107,52545707,21300107,36545707,63.2455532034,18.8059155866,19.2237643806,91,0,0,
The Messengers,2527,16000000,35374833,53774833,19374833,37774833,63.2455532034,18.8142424536,19.2151027983,78,0,0,
See Spot Run,2528,16000000,33357476,43057552,17357476,27057552,63.2455532034,18.7391911572,19.2059457278,29,0,0,
Double Impact,2529,16000000,29090445,29090445,13090445,13090445,63.2455532034,18.6320811092,19.1862963241,98,0,0,
Baby Boy,2530,16000000,28734552,28734552,12734552,12734552,63.2455532034,18.6291961762,19.1846398812,94,0,0,
Joe Dirt,2531,16000000,27087695,30987695,11087695,14987695,63.2455532034,18.6473216684,19.1769389398,62,0,0,
The Women,2532,16000000,26902075,50103808,10902075,34103808,63.2455532034,18.7891640441,19.1760672233,100,0,0,
Hot Fuzz,2533,16000000,23618786,81742618,7618786,65742618,63.2455532034,18.9870897486,19.1605211631,12,0,0,
Vicky Cristina Barcelona,2534,16000000,23216709,104504817,7216709,88504817,63.2455532034,19.1085895231,19.1586006487,27,0,0,
Boys and Girls,2535,16000000,20773721,20773721,4773721,4773721,63.2455532034,18.5623882968,19.1468517942,67,0,0,
Léon,2536,16000000,19284974,45284974,3284974,29284974,63.2455532034,18.7552598756,19.1396238064,53,0,0,
Remember Me,2537,16000000,19068240,56506120,3068240,40506120,63.2455532034,18.8325013597,19.1385671751,53,0,0,
White Oleander,2538,16000000,16357770,21657770,357770,5657770,63.2455532034,18.5700314538,19.1252578089,97,0,0,
Jennifer's Body,2539,16000000,16204793,31943401,204793,15943401,63.2455532034,18.6549117458,19.1245013306,61,0,0,
Drowning Mona,2540,16000000,15427192,15980376,-572808,-19624,63.2455532034,18.5198979904,19.1206471855,66,0,0,
Radio Days,2541,16000000,14792779,14792779,-1207221,-1207221,63.2455532034,18.509085509,19.1174917047,13,0,0,
How to Deal,2542,16000000,14108518,14108518,-1891482,-1891482,63.2455532034,18.5028021513,19.1140770885,0,0,0,
Left Behind,2543,16000000,14019924,20769209,-1980076,4769209,63.2455532034,18.5623491375,19.1136341308,61,0,0,
Soul Plane,2544,16000000,13922211,14553807,-2077789,-1446193,63.2455532034,18.5068955864,19.1131453517,11,0,0,
My Stepmother Is an Alien,2545,16000000,13854000,13854000,-2146000,-2146000,63.2455532034,18.5004548803,19.1128040055,62,0,0,
People Like Us,2546,16000000,12431792,12431792,-3568208,-3568208,63.2455532034,18.4872362984,19.1056602245,36,0,0,
The Thirteenth Floor,2547,16000000,11810854,11810854,-4189146,-4189146,63.2455532034,18.4814097934,19.1025251633,75,0,0,
The Cookout,2548,16000000,11540112,11540112,-4459888,-4459888,63.2455532034,18.478858648,19.1011551278,78,0,0,
Meteor,2549,16000000,8400000,8400000,-7600000,-7600000,63.2455532034,18.4487845271,19.0851265578,85,0,0,
Highlander,2550,16000000,5900000,12900000,-10100000,-3100000,63.2455532034,18.4916073367,19.0721791352,89,0,0,
Hollywood Ending,2551,16000000,4839383,14839383,-11160617,-1160617,63.2455532034,18.5095120265,19.0666351798,68,0,0,
Duets,2552,16000000,4734235,4734235,-11265765,-11265765,63.2455532034,18.4124920783,19.066083882,5,0,0,
Detroit Rock City,2553,16000000,4217115,4217115,-11782885,-11782885,63.2455532034,18.4072647203,19.0633681564,0,0,0,
Things We Lost in the Fire,2554,16000000,3287315,8120148,-12712685,-7879852,63.2455532034,18.4460598527,19.0584665562,41,0,0,
The Homesman,2555,16000000,2429989,2974779,-13570011,-13025221,63.2455532034,18.3945936248,19.0539256262,2,0,0,
Steel,2557,16000000,1686429,1686429,-14313571,-14313571,63.2455532034,18.3812813933,19.0499705048,1,0,0,
The White Countess,2558,16000000,1666262,2810857,-14333738,-13189143,63.2455532034,18.3929096626,19.0498630149,43,0,0,
Bienvenue chez les Ch'tis,2559,16000000,1477650,247474497,-14522350,231474497,63.2455532034,19.6501012094,19.0488571554,13,0,0,
Enter the Void,2560,16000000,337997,337997,-15662003,-15662003,63.2455532034,18.3671558985,19.042757815,84,0,0,
Good,2561,16000000,31631,31631,-15968369,-15968369,63.2455532034,18.3639185541,19.0411118018,41,0,0,
Vamps,2562,16000000,3361,3361,-15996639,-15996639,63.2455532034,18.3636192985,19.0409597789,14,0,0,
High Plains Drifter,2565,15700000,15700000,15700000,0,0,62.9469820661,18.520075679,19.1234877231,74,0,0,
Juwanna Mann,2566,15600000,13571817,13771817,-2028183,-1828183,62.8465077123,18.5033850665,19.1133935202,50,0,0,
La Môme,2567,15500000,10299782,88611837,-5200218,73111837,62.745549141,19.0280634735,19.0973992245,57,0,0,
Ararat,2568,15500000,1693000,1693000,-13807000,-13807000,62.745549141,18.3865368389,19.0526667391,46,0,0,
Slow Burn,2569,15500000,1237615,1237615,-14262385,-14262385,62.745549141,18.3818136812,19.0502432737,73,0,0,
Madison,2570,15500000,517262,517262,-14982738,-14982738,62.745549141,18.3742964754,19.0463976691,63,0,0,
The Yellow Handkerchief,2571,15500000,318623,318623,-15181377,-15181377,62.745549141,18.3722136102,19.0453346283,55,0,0,
Wasabi,2572,15300000,81525,7000000,-15218475,-8300000,62.5421573271,18.4419552484,19.0451359685,96,0,0,
Slither,2573,15250000,7802450,12930343,-7447550,-2319657,62.4909980553,18.4988501752,19.0859106949,41,0,0,
Home Alone,2574,15000000,277504018,468427450,262504018,453427450,62.2332977288,20.1503479278,19.9563544322,34,0,0,
Beverly Hills Cop,2575,15000000,229909722,311449244,214909722,296449244,62.2332977288,19.8240767498,19.8482395049,67,0,0,
Top Gun,2576,15000000,179800601,356800601,164800601,341800601,62.2332977288,19.9297475463,19.7201689489,74,0,0,
Tootsie,2577,15000000,176188774,176188774,161188774,161188774,62.2332977288,19.4199845958,19.7102717165,35,0,0,
3 Men and a Baby,2578,15000000,164016972,164016972,149016972,149016972,62.2332977288,19.3741409097,19.676177951,65,0,0,
The Kings Speech,2579,15000000,138797449,430821168,123797449,415821168,62.2332977288,20.0813276262,19.6016062991,81,0,0,
American Beauty,2580,15000000,130058047,356258047,115058047,341258047,62.2332977288,19.9285471512,19.5744103382,27,0,0,
"Crouching Tiger, Hidden Dragon",2581,15000000,128067808,213200000,113067808,198200000,62.2332977288,19.5477192909,19.5681121774,10,0,0,
Twins,2582,15000000,111936388,216600000,96936388,201600000,62.2332977288,19.5586747649,19.5155450477,94,0,0,
Scream,2583,15000000,103001286,173001286,88001286,158001286,62.2332977288,19.4081809268,19.4851935545,43,0,0,
Jackass Presents: Bad Grandpa,2584,15000000,102003019,160903019,87003019,145903019,62.2332977288,19.362066977,19.4817446324,58,0,0,
The Color Purple,2585,15000000,93589701,93589701,78589701,78589701,62.2332977288,19.0574688894,19.4521948722,50,0,0,
The Imitation Game,2586,15000000,91125143,227773686,76125143,212773686,62.2332977288,19.5938559166,19.4433707223,87,0,0,
Beetle Juice,2587,15000000,73326666,73326666,58326666,58326666,62.2332977288,18.9440883299,19.3772223774,85,0,0,
Mama,2589,15000000,71628180,148095566,56628180,133095566,62.2332977288,19.310815606,19.3706750785,100,0,0,
Private Benjamin,2590,15000000,69847348,69847348,54847348,54847348,62.2332977288,18.9232579832,19.363764005,51,0,0,
Coal Miner's Daughter,2591,15000000,67182787,67182787,52182787,52182787,62.2332977288,18.9070068649,19.3533333199,80,0,0,
Diary of a Wimpy Kid,2592,15000000,64003625,76954311,49003625,61954311,62.2332977288,18.9653543254,19.3407441344,45,0,0,
Lethal Weapon,2593,15000000,59932279,114932279,44932279,99932279,62.2332977288,19.1644379603,19.3243870228,50,0,0,
The Queen,2595,15000000,56441711,128885873,41441711,113885873,62.2332977288,19.2286559986,19.3101470237,88,0,0,
Why Did I Get Married?,2596,15000000,55204525,55934178,40204525,40934178,62.2332977288,18.8353329875,19.3050507721,18,0,0,
The Woman in Black,2597,15000000,54333290,128955898,39333290,113955898,62.2332977288,19.2289680931,19.3014463075,30,0,0,
Little Women,2598,15000000,50003303,50003303,35003303,35003303,62.2332977288,18.7953673153,19.2833370178,66,0,0,
The Deer Hunter,2599,15000000,50000000,50000000,35000000,35000000,62.2332977288,18.7953446068,19.2833230778,98,0,0,
When a Stranger Calls,2600,15000000,47860214,67215435,32860214,52215435,62.2332977288,18.9072075912,19.2742511834,30,0,0,
Big Fat Liar,2601,15000000,47811275,52461017,32811275,37461017,62.2332977288,18.8121230506,19.2740427346,18,0,0,
Cop Land,2602,15000000,44810734,63610734,29810734,48610734,62.2332977288,18.8847981836,19.2611786297,8,0,0,
Wag the Dog,2603,15000000,43022524,64217092,28022524,49217092,62.2332977288,18.8886030463,19.2534326589,23,0,0,
The Lizzie McGuire Movie,2605,15000000,42672630,55472630,27672630,40472630,62.2332977288,18.8322794829,19.2519099828,85,0,0,
End of Watch,2606,15000000,41003371,55763960,26003371,40763960,62.2332977288,18.8342079459,19.2446135786,18,0,0,
The Faculty,2607,15000000,40064955,40064955,25064955,25064955,62.2332977288,18.7245943471,19.2404882227,91,0,0,
What's Love Got to Do With It,2608,15000000,39100956,39100956,24100956,24100956,62.2332977288,18.7174553389,19.2362326062,94,0,0,
Not Another Teen Movie,2609,15000000,37882551,62401343,22882551,47401343,62.2332977288,18.8771658142,19.2308278626,18,0,0,
Wild,2610,15000000,37880356,52501541,22880356,37501541,62.2332977288,18.8123969882,19.2308180993,20,0,0,
Lawrence of Arabia,2611,15000000,37495385,69995385,22495385,54995385,62.2332977288,18.9241531611,19.2291042923,23,0,0,
The Theory of Everything,2612,15000000,35893537,122147772,20893537,107147772,62.2332977288,19.1981599461,19.221941508,76,0,0,
Drive,2613,15000000,35060689,78054825,20060689,63054825,62.2332977288,18.9717173616,19.2181969939,31,0,0,
The Skulls,2614,15000000,35007180,35007180,20007180,20007180,62.2332977288,18.6865574634,19.2179559355,0,0,0,
Hawaii,2615,15000000,34562222,34562222,19562222,19562222,62.2332977288,18.6831408808,19.2159491429,81,0,0,
Malibu's Most Wanted,2616,15000000,34308901,34499204,19308901,19499204,62.2332977288,18.6826560559,19.2148048453,65,0,0,
All About Steve,2617,15000000,33862903,40127259,18862903,25127259,62.2332977288,18.7250539979,19.2127870027,41,0,0,
Where the Heart Is,2618,15000000,33771174,40862054,18771174,25862054,62.2332977288,18.7304591054,19.212371485,33,0,0,
Halloween 2,2619,15000000,33392973,38512850,18392973,23512850,62.2332977288,18.7130748872,19.2106564692,17,0,0,
Because of Winn-Dixie,2621,15000000,32645546,33506989,17645546,18506989,62.2332977288,18.6749913648,19.2072584617,40,0,0,
Earth,2622,15000000,32011576,109011576,17011576,94011576,62.2332977288,19.135891807,19.2043671825,86,0,0,
The Wedding Date,2623,15000000,31585300,47033343,16585300,32033343,62.2332977288,18.7747373581,19.2024184004,1,0,0,
The Princess Bride,2624,15000000,30857000,30857000,15857000,15857000,62.2332977288,18.6542279254,19.1990800596,89,0,0,
Halloween: Resurrection,2625,15000000,30259652,37659652,15259652,22659652,62.2332977288,18.7066856158,19.1963336258,70,0,0,
The Great Debaters,2626,15000000,30226144,30261293,15226144,15261293,62.2332977288,18.6495004355,19.196179342,86,0,0,
When the Game Stands Tall,2627,15000000,30127963,30138912,15127963,15138912,62.2332977288,18.6485264548,19.1957271417,12,0,0,
Clash of the Titans,2628,15000000,30000000,44400000,15000000,29400000,62.2332977288,18.7560827081,19.1951374648,70,0,0,
Confessions of a Teenage Drama Queen,2629,15000000,29302097,33089883,14302097,18089883,62.2332977288,18.6717516704,19.1919152664,23,0,0,
The Object of my Affection,2630,15000000,29106737,29106737,14106737,14106737,62.2332977288,18.6402738319,19.1910114317,85,0,0,
28 Weeks Later,2631,15000000,28637507,64231305,13637507,49231305,62.2332977288,18.8886920587,19.1888371919,33,0,0,
Grosse Pointe Blank,2632,15000000,28073151,31059206,13073151,16059206,62.2332977288,18.6558275512,19.1862158955,89,0,0,
Love and Basketball,2633,15000000,27441122,27709625,12441122,12709625,62.2332977288,18.6289938012,19.1832720949,31,0,0,
Book of Shadows: Blair Witch 2,2634,15000000,26421314,47721314,11421314,32721314,62.2332977288,18.7795541615,19.1785037878,58,0,0,
Boogie Nights,2635,15000000,26384919,43085873,11384919,28085873,62.2332977288,18.7466416078,19.1783331951,53,0,0,
Ramona and Beezus,2636,15000000,26167002,27469621,11167002,12469621,62.2332977288,18.6270431808,19.1773111531,78,0,0,
The November Man,2637,15000000,25018119,34820335,10018119,19820335,62.2332977288,18.685124207,19.1719054936,15,0,0,
The Craft,2638,15000000,24703049,55603049,9703049,40603049,62.2332977288,18.8331432531,19.1704179241,98,0,0,
Match Point,2639,15000000,23089926,87989926,8089926,72989926,62.2332977288,19.0273991124,19.1627668729,87,0,0,
The Remains of the Day,2640,15000000,22954968,63954968,7954968,48954968,62.2332977288,18.8869600089,19.1621241048,56,0,0,
Urban Legends: Final Cut,2641,15000000,21468807,38574362,6468807,23574362,62.2332977288,18.7135339531,19.1550184656,30,0,0,
The Place Beyond the Pines,2642,15000000,21403519,47011449,6403519,32011449,62.2332977288,18.7745836865,19.1547051496,82,0,0,
Flicka,2643,15000000,21000147,21896367,6000147,6896367,62.2332977288,18.5806425835,19.1527671943,38,0,0,
The Hills Have Eyes II,2644,15000000,20804166,37466538,5804166,22466538,62.2332977288,18.7052337761,19.1518242683,100,0,0,
Nowhere to Run,2645,15000000,20570994,50570994,5570994,35570994,62.2332977288,18.7992626212,19.1507012453,89,0,0,
Country Strong,2646,15000000,20218921,20601987,5218921,5601987,62.2332977288,18.5695508978,19.1490031677,24,0,0,
Tuck Everlasting,2647,15000000,19161999,19344615,4161999,4344615,62.2332977288,18.5586572413,19.1438881545,77,0,0,
The Marine,2648,15000000,18844784,22165608,3844784,7165608,62.2332977288,18.5829343633,19.1423478621,37,0,0,
The Big Lebowski,2649,15000000,17439163,46129927,2439163,31129927,62.2332977288,18.7683766801,19.1354939323,76,0,0,
Disturbing Behavior,2650,15000000,17411331,17411331,2411331,2411331,62.2332977288,18.5416726081,19.1353577457,86,0,0,
A Most Wanted Man,2651,15000000,17237855,36068890,2237855,21068890,62.2332977288,18.6946628896,19.1345084801,99,0,0,
The Hurt Locker,2652,15000000,17017811,49894223,2017811,34894223,62.2332977288,18.7946171038,19.1334301985,22,0,0,
Eye of the Beholder,2653,15000000,16500786,18260865,1500786,3260865,62.2332977288,18.5491716409,19.1308920359,64,0,0,
The Man with the Iron Fists,2654,15000000,15634090,22018988,634090,7018988,62.2332977288,18.581686985,19.1266227752,7,0,0,
Firestarter,2655,15000000,15136870,15136870,136870,136870,62.2332977288,18.5213141123,19.1241652647,28,0,0,
Killing Them Softly,2656,15000000,14945541,38123368,-54459,23123368,62.2332977288,18.7101632697,19.1232180094,11,0,0,
Freddy Got Fingered,2657,15000000,14249005,14249005,-750995,-750995,62.2332977288,18.5132530611,19.1197619136,87,0,0,
One Day,2658,15000000,13843771,59168692,-1156229,44168692,62.2332977288,18.8564741576,19.1177457,32,0,0,
De-Lovely,2659,15000000,13337299,18524496,-1662701,3524496,62.2332977288,18.5514873854,19.1152200551,81,0,0,
Whip It,2660,15000000,13043363,18856151,-1956637,3856151,62.2332977288,18.554393059,19.1137513416,69,0,0,
U2 3D,2661,15000000,12898847,26170402,-2101153,11170402,62.2332977288,18.6164172829,19.1130284451,72,0,0,
Highlander: Endgame,2662,15000000,12801190,12801190,-2198810,-2198810,62.2332977288,18.4999671535,19.1125396501,34,0,0,
The Pirates Who Don't Do Anything: A VeggieTales Movie,2663,15000000,12727025,12994200,-2272975,-2005800,62.2332977288,18.5017485446,19.1121682781,29,0,0,
Idlewild,2664,15000000,12571185,12571185,-2428815,-2428815,62.2332977288,18.4978401637,19.1113874791,36,0,0,
Confidence,2665,15000000,12212417,12212417,-2787583,-2787583,62.2332977288,18.494513369,19.1095876372,88,0,0,
Knockaround Guys,2666,15000000,11660180,12419700,-3339820,-2580300,62.2332977288,18.4964368188,19.1068108675,24,0,0,
The Muse,2667,15000000,11614954,11614954,-3385046,-3385046,62.2332977288,18.4889485154,19.1065831192,23,0,0,
Barney's Great Adventure,2668,15000000,11144518,11144518,-3855482,-3855482,62.2332977288,18.4845449129,19.1042110251,64,0,0,
New York Stories,2669,15000000,10763469,10763469,-4236531,-4236531,62.2332977288,18.480963764,19.1022855165,22,0,0,
Here on Earth,2670,15000000,10494147,10845127,-4505853,-4154873,62.2332977288,18.4817322771,19.1009223447,31,0,0,
Home Fries,2671,15000000,10443316,10443316,-4556684,-4556684,62.2332977288,18.4779449778,19.1006648552,36,0,0,
Raise Your Voice,2672,15000000,10411980,14811980,-4588020,-188020,62.2332977288,18.5183719234,19.1005060866,100,0,0,
Brazil,2673,15000000,9929135,9929135,-5070865,-5070865,62.2332977288,18.4730775109,19.0980564867,58,0,0,
The Dark Half,2674,15000000,9579068,9579068,-5420932,-5420932,62.2332977288,18.4697500121,19.0962767448,92,0,0,
Black Snake Moan,2675,15000000,9396870,10951153,-5603130,-4048847,62.2332977288,18.4827292458,19.0953491946,12,0,0,
Dark Blue,2676,15000000,9237470,12262065,-5762530,-2737935,62.2332977288,18.4949744068,19.0945370004,27,0,0,
Peeples,2677,15000000,9177065,9307166,-5822935,-5692834,62.2332977288,18.4671578351,19.0942290451,95,0,0,
A Mighty Heart,2678,15000000,9176787,18935657,-5823213,3935657,62.2332977288,18.5550883689,19.0942276276,41,0,0,
Brainstorm,2679,15000000,8921050,8921050,-6078950,-6078950,62.2332977288,18.4634652149,19.0929227818,17,0,0,
Whatever it Takes,2680,15000000,8735529,8735529,-6264471,-6264471,62.2332977288,18.4616861234,19.0919751321,75,0,0,
Boat Trip,2681,15000000,8586376,14933713,-6413624,-66287,62.2332977288,18.5194753462,19.0912126,58,0,0,
The Importance of Being Earnest,2682,15000000,8378141,8378141,-6621859,-6621859,62.2332977288,18.4582499307,19.0901470428,53,0,0,
Hoot,2684,15000000,8117637,8224998,-6882363,-6775002,62.2332977288,18.4567738791,19.0888124196,96,0,0,
In Bruges,2685,15000000,7800825,34533783,-7199175,19533783,62.2332977288,18.6829221163,19.0871869133,100,0,0,
Promised Land,2686,15000000,7597898,9300336,-7402102,-5699664,62.2332977288,18.4670926347,19.0861443409,71,0,0,
Mulholland Drive,2687,15000000,7219578,11919578,-7780422,-3080422,62.2332977288,18.4917896951,19.0841977496,23,0,0,
The Rocker,2688,15000000,6409528,8767338,-8590472,-6232662,62.2332977288,18.4619913872,19.0800169671,66,0,0,
Post Grad,2689,15000000,6380019,6561243,-8619981,-8438757,62.2332977288,18.440595963,19.0798643365,79,0,0,
Whatever Works,2690,15000000,5306706,35106706,-9693294,20106706,62.2332977288,18.6873200728,19.0742969037,44,0,0,
The In Crowd,2691,15000000,5217498,5217498,-9782502,-9782502,62.2332977288,18.427335949,19.0738327704,84,0,0,
Los tres entierros de Melquiades Estrada,2692,15000000,5027684,13454474,-9972316,-1545526,62.2332977288,18.5059838928,19.0728444847,57,0,0,
Jakob the Liar,2693,15000000,4956401,4956401,-10043599,-10043599,62.2332977288,18.4247389285,19.0724730902,77,0,0,
Se jie,2694,15000000,4604982,65696051,-10395018,50696051,62.2332977288,18.8978231626,19.0706401285,55,0,0,
"Kiss Kiss, Bang Bang",2695,15000000,4235837,16829464,-10764163,1829464,62.2332977288,18.5365036911,19.068711085,33,0,0,
Idle Hands,2696,15000000,4023741,4023741,-10976259,-10976259,62.2332977288,18.4154066907,19.0676010479,5,0,0,
Scout's Guide to the Zombie Apocalypse,2697,15000000,3703046,14003046,-11296954,-996954,62.2332977288,18.5110084227,19.0659202976,46,0,0,
Blood and Chocolate,2698,15000000,3526588,6551310,-11473412,-8448690,62.2332977288,18.4404985869,19.0649942817,76,0,0,
You Will Meet a Tall Dark Stranger,2699,15000000,3247816,34247816,-11752184,19247816,62.2332977288,18.6807196762,19.0635295929,63,0,0,
Never Let Me Go,2700,15000000,2419730,11158796,-12580270,-3841204,62.2332977288,18.4846788504,19.0591660735,58,0,0,
The Company,2701,15000000,2281585,3396508,-12718415,-11603492,62.2332977288,18.409081229,19.058436275,90,0,0,
Transsiberian,2702,15000000,2203641,6379575,-12796359,-8620425,62.2332977288,18.4388135171,19.0580242738,54,0,0,
Crazy in Alabama,2703,15000000,1954202,1954202,-13045798,-13045798,62.2332977288,18.394382394,19.0567046319,96,0,0,
The Clan of the Cave Bear,2704,15000000,1953732,1953732,-13046268,-13046268,62.2332977288,18.3943775687,19.0567021437,80,0,0,
Banlieue 13,2705,15000000,1200216,11599903,-13799784,-3400097,62.2332977288,18.4888079276,19.052705094,14,0,0,
Felicia's Journey,2706,15000000,824295,1970268,-14175705,-13029732,62.2332977288,18.3945473215,19.0507050196,89,0,0,
Metropolis,2707,15000000,673414,1405032,-14326586,-13594968,62.2332977288,18.3887284018,19.0499011363,29,0,0,
Nie yin niang,2708,15000000,545638,6745638,-14454362,-8254362,62.2332977288,18.4424019219,19.049219849,58,0,0,
Things to Do in Denver when You're Dead,2709,15000000,529766,529766,-14470234,-14470234,62.2332977288,18.3796504778,19.0491351889,7,0,0,
The Return,2710,15000000,501752,5953886,-14498248,-9046114,62.2332977288,18.4346243585,19.0489857467,75,0,0,
Buffalo Soldiers,2711,15000000,353743,353743,-14646257,-14646257,62.2332977288,18.3778148393,19.0481958137,42,0,0,
Steal (Canadian Release),2712,15000000,220944,220944,-14779056,-14779056,62.2332977288,18.3764277245,19.0474865259,3,0,0,
Centurion,2713,15000000,123570,6623570,-14876430,-8376430,62.2332977288,18.4412067567,19.0469661254,84,0,0,
Ong-Bak 2,2714,15000000,102458,7583050,-14897542,-7416950,62.2332977288,18.4505627174,19.0468532598,9,0,0,
Silent Trigger,2715,15000000,76382,76382,-14923618,-14923618,62.2332977288,18.374915552,19.0467138388,23,0,0,
Midnight Meat Train,2716,15000000,73548,1590246,-14926452,-13409754,62.2332977288,18.3906388515,19.0466986851,28,0,0,
Winnie Mandela,2717,15000000,61847,61847,-14938153,-14938153,62.2332977288,18.3747633839,19.0466361159,8,0,0,
Heist,2718,15000000,50136,1620834,-14949864,-13379166,62.2332977288,18.3909540105,19.0465734893,86,0,0,
The Son of No One,2719,15000000,30680,1148578,-14969320,-13851422,62.2332977288,18.3860770839,19.0464694364,10,0,0,
All the Queen's Men,2720,15000000,22723,22723,-14977277,-14977277,62.2332977288,18.3743536765,19.0464268783,18,0,0,
The Good Night,2721,15000000,22441,22441,-14977559,-14977559,62.2332977288,18.3743507228,19.04642537,83,0,0,
Groundhog Day,2729,14600000,68504696,68504696,53904696,53904696,61.8141944452,18.9175389033,19.3600863254,71,0,0,
Magic Mike XXL,2730,14500000,66013057,117813057,51513057,103313057,61.7080752652,19.1803798814,19.3506943964,82,0,0,
Romeo+Juliet,2731,14500000,46338728,147542381,31838728,133042381,61.7080752652,19.3105972044,19.2698912698,74,0,0,
Elle s'appelait Sarah,2732,14500000,7691700,25480031,-6808300,10980031,61.7080752652,18.6148507713,19.089192043,18,0,0,
Unforgiven,2734,14400000,99162710,157162710,84762710,142762710,61.6014057648,19.3497414002,19.4739609908,86,0,0,
Manderlay,2735,14200000,74205,543306,-14125795,-13656694,61.386388852,18.3880908972,19.0509707944,1,0,0,
Pretty Woman,2736,14000000,175119672,429359276,161119672,415359276,61.1690884906,20.0804495721,19.7100814029,65,0,0,
Fatal Attraction,2737,14000000,148453989,311908296,134453989,297908296,61.1690884906,19.8276561161,19.6337975443,86,0,0,
Slumdog Millionaire,2738,14000000,141319928,384519665,127319928,370519665,61.1690884906,19.9913152627,19.6123620636,25,0,0,
Towering Inferno,2739,14000000,116000000,139700000,102000000,125700000,61.1690884906,19.2799787791,19.5323452177,49,0,0,
Crocodile Dundee 2,2740,14000000,109306210,239606210,95306210,225606210,61.1690884906,19.6327897157,19.5100757874,49,0,0,
Born on the Fourth of July,2741,14000000,65441414,65441414,51441414,51441414,61.1690884906,18.9024378794,19.3504116902,85,0,0,
Cool Runnings,2742,14000000,63924600,150124600,49924600,136124600,61.1690884906,19.3231761241,19.3444074444,47,0,0,
Stomp the Yard,2743,14000000,61356221,75525718,47356221,61525718,61.1690884906,18.9628652576,19.3341576889,4,0,0,
My Bloody Valentine,2744,14000000,51545952,102836002,37545952,88836002,61.1690884906,19.1102527613,19.2940108336,26,0,0,
The Possession,2745,14000000,49130588,82925064,35130588,68925064,61.1690884906,19.0049908505,19.2838740666,88,0,0,
First Blood,2746,14000000,47212904,125212904,33212904,111212904,61.1690884906,19.2166694272,19.2757521335,100,0,0,
The Spy Who Loved Me,2747,14000000,46800000,185400000,32800000,171400000,61.1690884906,19.4568864311,19.2739947042,17,0,0,
Urban Legend,2748,14000000,38048637,72503794,24048637,58503794,61.1690884906,18.9451372596,19.2360011227,72,0,0,
Taps,2749,14000000,35856053,35856053,21856053,21856053,61.1690884906,18.7006302093,19.2262516201,73,0,0,
Tyler Perry's Good Deeds,2750,14000000,35025791,35579177,21025791,21579177,61.1690884906,18.698535327,19.2225348388,92,0,0,
White Fang,2751,14000000,34729091,34729091,20729091,20729091,61.1690884906,18.6920758993,19.2212032631,85,0,0,
Dangerous Liaisons,2752,14000000,32663833,32663833,18663833,18663833,61.1690884906,18.676206874,19.2118850281,67,0,0,
Superstar,2753,14000000,30628981,30628981,16628981,16628981,61.1690884906,18.6603212532,19.2026182691,97,0,0,
The Iron Lady,2754,14000000,29959436,115592104,15959436,101592104,61.1690884906,19.172296558,19.199550274,36,0,0,
Jonah: A VeggieTales Movie,2755,14000000,25571351,25608779,11571351,11608779,61.1690884906,18.6200152645,19.1792067425,34,0,0,
All About the Benjamins,2756,14000000,25482931,25873145,11482931,11873145,61.1690884906,18.6221788089,19.1787925362,49,0,0,
Poetic Justice,2757,14000000,25107237,25107237,11107237,11107237,61.1690884906,18.6158977872,19.1770306696,36,0,0,
Exorcist II: The Heretic,2758,14000000,25011000,25011000,11011000,11011000,61.1690884906,18.6151057741,19.1765788536,96,0,0,
Our Family Wedding,2759,14000000,20249621,21404886,6249621,7404886,61.1690884906,18.5849666994,19.153966207,14,0,0,
Vampire in Brooklyn,2760,14000000,19556475,19556475,5556475,5556475,61.1690884906,18.5691586527,19.1506312759,95,0,0,
An American Haunting,2761,14000000,16298046,30443277,2298046,16443277,61.1690884906,18.6588588597,19.1348032316,21,0,0,
My Boss's Daughter,2762,14000000,15549702,15549702,1549702,1549702,61.1690884906,18.5340089293,19.1311324489,63,0,0,
A Perfect Getaway,2763,14000000,15515460,22815460,1515460,8815460,61.1690884906,18.5968643521,19.130964162,10,0,0,
Thinner,2764,14000000,15171475,15171475,1171475,1171475,61.1690884906,18.5306261858,19.1292720281,68,0,0,
Dead Man on Campus,2765,14000000,15062898,15062898,1062898,1062898,61.1690884906,18.5296529895,19.1287373201,72,0,0,
Tea with Mussolini,2766,14000000,14395874,14395874,395874,395874,61.1690884906,18.5236534552,19.1254461459,55,0,0,
"New York, New York",2767,14000000,13800000,13800000,-200000,-200000,61.1690884906,18.5182632674,19.1224968457,21,0,0,
Crooklyn,2768,14000000,13024170,13024170,-975830,-975830,61.1690884906,18.5112013996,19.1186437648,37,0,0,
Jason X,2769,14000000,12610731,16440974,-1389269,2440974,61.1690884906,18.5419352228,19.116584382,100,0,0,
I Think I Love My Wife,2770,14000000,12550605,13196245,-1449395,-803755,61.1690884906,18.5127719941,19.1162845346,37,0,0,
Hot Tub Time Machine 2,2771,14000000,12314651,12452601,-1685349,-1547399,61.1690884906,18.5059666942,19.1151069662,81,0,0,
Bobby,2772,14000000,11205901,20560906,-2794099,6560906,61.1690884906,18.5777797704,19.1095549183,0,0,0,
Head Over Heels,2773,14000000,10397365,10397365,-3602635,-3602635,61.1690884906,18.4869141437,19.1054866628,25,0,0,
Fun Size ,2774,14000000,9409538,10911519,-4590462,-3088481,61.1690884906,18.4917146339,19.1004937128,60,0,0,
Lost and Found,2775,14000000,6552255,6552255,-7447745,-7447745,61.1690884906,18.4502637887,19.0859096923,77,0,0,
Le Scaphandre et le Papillon,2776,14000000,5990075,22754472,-8009925,8754472,61.1690884906,18.5963528589,19.0830150257,58,0,0,
Little Children,2777,14000000,5463019,14121177,-8536981,121177,61.1690884906,18.521172196,19.0802935813,19,0,0,
Gossip,2778,14000000,5108820,12591270,-8891180,-1408730,61.1690884906,18.5072392118,19.0784605111,1,0,0,
A Walk on the Moon,2779,14000000,4741987,4741987,-9258013,-9258013,61.1690884906,18.4325325234,19.076558508,7,0,0,
Catch a Fire,2780,14000000,4299773,5782198,-9700227,-8217802,61.1690884906,18.4427596023,19.0742608402,17,0,0,
Soul Survivors,2781,14000000,3100650,4288246,-10899350,-9711754,61.1690884906,18.4280384893,19.0680037054,43,0,0,
Easy Virtue,2782,14000000,2656784,20537741,-11343216,6537741,61.1690884906,18.5775817782,19.0656776069,51,0,0,
Jefferson in Paris,2783,14000000,2442542,2442542,-11557458,-11557458,61.1690884906,18.4095468314,19.0645529236,93,0,0,
Flipped,2784,14000000,1755212,1755212,-12244788,-12244788,61.1690884906,18.4025723116,19.0609361586,64,0,0,
Caravans,2785,14000000,1000000,1000000,-13000000,-13000000,61.1690884906,18.3948524673,19.056947054,75,0,0,
Les herbes folles,2786,14000000,403952,1903952,-13596048,-12096048,61.1690884906,18.4040857456,19.0537873949,44,0,0,
Amen,2787,14000000,274299,274299,-13725701,-13725701,61.1690884906,18.3873777132,19.0530987785,8,0,0,
The Lucky Ones,2788,14000000,266967,266967,-13733033,-13733033,61.1690884906,18.3873019075,19.0530598225,78,0,0,
Margaret,2789,14000000,47185,47185,-13952815,-13952815,61.1690884906,18.3850269028,19.0518913807,70,0,0,
Brokeback Mountain,2791,13900000,83043761,177012173,69143761,163112173,61.0595641686,19.4270403622,19.4179432853,11,0,0,
Clueless,2792,13700000,56598476,56598476,42898476,42898476,60.8387303012,18.8482250886,19.3161146649,72,0,0,
Teenage Mutant Ninja Turtles,2793,13500000,124635290,191369375,111135290,177869375,60.6154651403,19.479580204,19.5619584822,28,0,0,
Far From Heaven,2795,13500000,15901849,29027914,2401849,15527914,60.6154651403,18.6516190849,19.1353113444,52,0,0,
Seven Psychopaths,2796,13500000,15024049,32611979,1524049,19111979,60.6154651403,18.6796717948,19.1310063764,100,0,0,
Quills,2797,13500000,7060876,11732088,-6439124,-1767912,60.6154651403,18.5039397815,19.0910821752,42,0,0,
The Border,2798,13500000,6118683,6118683,-7381317,-7381317,60.6154651403,18.4509084973,19.0862511774,25,0,0,
Downfall,2799,13500000,5501940,93631744,-7998060,80131744,60.6154651403,19.0655930327,19.0830762052,99,0,0,
The Caveman's Valentine,2800,13500000,687081,892506,-12812919,-12607494,60.6154651403,18.3988721357,19.0579367181,84,0,0,
The Last Godfather,2801,13400000,164247,164247,-13235753,-13235753,60.5029011168,18.3924303222,19.0556985171,69,0,0,
Under the Skin,2802,13300000,2605039,7220721,-10694961,-6079279,60.3897052962,18.4634620626,19.0690729979,43,0,0,
Mar adentro,2803,13300000,2086345,39686345,-11213655,26386345,60.3897052962,18.7342979763,19.0663571361,51,0,0,
No Good Deed,2804,13200000,52543632,54323210,39343632,41123210,60.2758693419,18.8365808972,19.3014891706,98,0,0,
Good Morning Vietnam,2805,13000000,121650966,121650966,108650966,108650966,60.0462428089,19.2050443181,19.5539916358,69,0,0,
Black Swan,2806,13000000,106954678,331266710,93954678,318266710,60.0462428089,19.8763074736,19.5055185959,46,0,0,
Save the Last Dance,2807,13000000,91038276,122244329,78038276,109244329,60.0462428089,19.2077488261,19.4502272907,57,0,0,
Justin Bieber: Never Say Never,2808,13000000,73013910,99034125,60013910,86034125,60.0462428089,19.0960934289,19.3836841731,41,0,0,
Snow Day,2809,13000000,60008303,62452927,47008303,49452927,60.0462428089,18.8900789963,19.3327611207,73,0,0,
The Butterfly Effect,2810,13000000,57924679,95638592,44924679,82638592,60.0462428089,19.0786609208,19.3243562373,26,0,0,
The Godfather: Part II,2811,13000000,57300000,57300000,44300000,44300000,60.0462428089,18.8573230334,19.3218225928,64,0,0,
RoboCop,2812,13000000,51327050,51327050,38327050,38327050,60.0462428089,18.8179610613,19.2972670691,12,0,0,
A Nightmare on Elm Street 4: The Dream Master,2813,13000000,49369899,49369899,36369899,36369899,60.0462428089,18.8047188651,19.2890880245,100,0,0,
This Christmas,2814,13000000,49121934,49733545,36121934,36733545,60.0462428089,18.8071926156,19.2880469737,11,0,0,
About Last Night,2815,13000000,48637684,50445860,35637684,37445860,60.0462428089,18.8120205718,19.2860107788,75,0,0,
"Dude, Where's My Car?",2816,13000000,46729374,73180297,33729374,60180297,60.0462428089,18.9550111864,19.2779460284,63,0,0,
Young Guns,2817,13000000,44726644,44726644,31726644,31726644,60.0462428089,18.7725825165,19.2694117127,52,0,0,
St. Vincent,2818,13000000,44137712,54837234,31137712,41837234,60.0462428089,18.8412805821,19.2668881515,100,0,0,
Earth to Echo,2819,13000000,38934842,38934842,25934842,25934842,60.0462428089,18.7309929426,19.2443128947,7,0,0,
Ten Things I Hate About You,2820,13000000,38177966,60414025,25177966,47414025,60.0462428089,18.8772461522,19.2409859309,35,0,0,
The New Guy,2821,13000000,28972187,28972187,15972187,15972187,60.0462428089,18.6551394686,19.1996087898,44,0,0,
Baby Geniuses,2822,13000000,27151490,27151490,14151490,14151490,60.0462428089,18.6406330648,19.191218554,38,0,0,
The Big Hit,2823,13000000,27052167,27052167,14052167,14052167,60.0462428089,18.6398356232,19.1907588171,66,0,0,
Harriet the Spy,2824,13000000,26539321,26539321,13539321,13539321,60.0462428089,18.6357079508,19.1883816352,33,0,0,
Loaded Weapon 1,2825,13000000,25726318,25726318,12726318,12726318,60.0462428089,18.6291293313,19.1846015249,58,0,0,
21 and Over,2826,13000000,25682380,42195766,12682380,29195766,60.0462428089,18.7546212643,19.1843968248,39,0,0,
The Mist,2827,13000000,25593755,57189408,12593755,44189408,60.0462428089,18.8566081296,19.1839838075,52,0,0,
Child's Play 2,2828,13000000,25459435,32721435,12459435,19721435,60.0462428089,18.6843647296,19.1833575133,39,0,0,
Ex Machina,2829,13000000,25440971,38132136,12440971,25132136,60.0462428089,18.7250899693,19.1832713905,73,0,0,
Being John Malkovich,2830,13000000,22858926,32382381,9858926,19382381,60.0462428089,18.6817566636,19.1711541574,94,0,0,
Two Can Play That Game,2831,13000000,22235901,22391450,9235901,9391450,60.0462428089,18.6016821965,19.1682082536,7,0,0,
Admission,2832,13000000,18007317,18733666,5007317,5733666,60.0462428089,18.5706849075,19.1479811949,82,0,0,
The Perks of Being a Wallflower,2833,13000000,17742948,33069303,4742948,20069303,60.0462428089,18.6870335437,19.1467029163,8,0,0,
crazy/beautiful,2834,13000000,16929123,19929123,3929123,6929123,60.0462428089,18.5809216834,19.1427576163,26,0,0,
54,2835,13000000,16574731,16574731,3574731,3574731,60.0462428089,18.5519280439,19.1410347008,82,0,0,
Letters from Iwo Jima,2836,13000000,13756082,67867998,756082,54867998,60.0462428089,18.9233829016,19.1272247994,86,0,0,
Män som hatar kvinnor,2837,13000000,12749992,109421911,-250008,96421911,60.0462428089,19.1476115421,19.1222489331,35,0,0,
The Astronaut Farmer,2838,13000000,11003643,11141213,-1996357,-1858787,60.0462428089,18.5031032792,19.1135527067,29,0,0,
Dirty Work,2839,13000000,9975684,9975684,-3024316,-3024316,60.0462428089,18.4923121076,19.1083982354,46,0,0,
Woo,2840,13000000,8026971,8026971,-4973029,-4973029,60.0462428089,18.4740054971,19.0985533195,12,0,0,
Serial Mom,2841,13000000,7881335,7881335,-5118665,-5118665,60.0462428089,18.4726238088,19.097813658,45,0,0,
Dick,2842,13000000,6241697,6241697,-6758303,-6758303,60.0462428089,18.4569349364,19.0894482303,88,0,0,
Light It Up,2843,13000000,5871603,5871603,-7128397,-7128397,60.0462428089,18.4533593833,19.087550292,20,0,0,
Bubble Boy,2844,13000000,5002310,5002310,-7997690,-7997690,60.0462428089,18.4449103421,19.083078113,55,0,0,
Birthday Girl,2845,13000000,4919896,8130727,-8080104,-4869273,60.0462428089,18.4749886953,19.0826530848,55,0,0,
"Paris, je t'aime",2846,13000000,4857374,4857374,-8142626,-8142626,60.0462428089,18.443494676,19.0823305237,63,0,0,
Resurrecting the Champ,2847,13000000,3172382,3260555,-9827618,-9739445,60.0462428089,18.4277635715,19.0735979579,70,0,0,
Chloe,2848,13000000,3075255,11831131,-9924745,-1168869,60.0462428089,18.5094365179,19.0730922597,1,0,0,
The Widow of St. Pierre,2849,13000000,3058380,3058380,-9941620,-9941620,60.0462428089,18.4257540729,19.0730043728,7,0,0,
Faithful,2850,13000000,2101580,2101580,-10898420,-10898420,60.0462428089,18.4161888908,19.0680085734,8,0,0,
Un Prophète,2851,13000000,2087720,19910624,-10912280,6910624,60.0462428089,18.5807640709,19.0679360216,92,0,0,
"I Love You, Phillip Morris",2852,13000000,2037459,23014027,-10962541,10014027,60.0462428089,18.6068637442,19.0676728804,9,0,0,
The Vatican Tapes,2853,13000000,1784763,12127591,-11215237,-872409,60.0462428089,18.5121456585,19.0663488416,76,0,0,
Find Me Guilty,2854,13000000,1173673,2898225,-11826327,-10101775,60.0462428089,18.4241593567,19.0631396787,2,0,0,
Excessive Force,2855,13000000,1152117,1152117,-11847883,-11847883,60.0462428089,18.4066057443,19.0630262882,57,0,0,
Infamous,2856,13000000,1151330,2613717,-11848670,-10386283,60.0462428089,18.4213201296,19.0630221482,7,0,0,
Attack the Block,2857,13000000,1024175,6459183,-11975825,-6540817,60.0462428089,18.4590301643,19.0623530137,21,0,0,
Brothers,2858,13000000,656688,17856688,-12343312,4856688,60.0462428089,18.5631080876,19.0604166467,89,0,0,
The Claim,2859,13000000,622023,1375635,-12377977,-11624365,60.0462428089,18.4088700415,19.0602337958,7,0,0,
The Killer Inside Me,2860,13000000,217277,3617277,-12782723,-9382723,60.0462428089,18.4312993565,19.0580963641,83,0,0,
The Call,2862,12800000,51872378,68553522,39072378,55753522,59.8139512488,18.9287250876,19.3003643322,23,0,0,
Crocodile Hunter: Collision Course,2864,12500000,28436931,33436931,15936931,20936931,59.4603557501,18.6936590414,19.1994469877,26,0,0,
Machete,2865,12500000,26593646,46370970,14093646,33870970,59.4603557501,18.7875520123,19.1909508369,20,0,0,
Antwone Fisher,2866,12500000,21078145,23367586,8578145,10867586,59.4603557501,18.6139243376,19.1650886819,3,0,0,
La Guerre du feu,2867,12500000,20959585,20959585,8459585,8459585,59.4603557501,18.5938760076,19.1645253449,60,0,0,
The Emperor's Club,2868,12500000,14060950,16193713,1560950,3693713,59.4603557501,18.552970973,19.1311877225,11,0,0,
True Romance,2869,12500000,12281000,12309980,-219000,-190020,59.4603557501,18.5183537846,19.1224026612,35,0,0,
Sorority Row,2870,12500000,11965282,26735797,-534718,14235797,59.4603557501,18.6413094478,19.1208363233,96,0,0,
Glengarry Glen Ross,2871,12500000,10725228,10725228,-1774772,-1774772,59.4603557501,18.5038766597,19.114660323,89,0,0,
The Boy in the Striped Pajamas,2872,12500000,9046156,44083403,-3453844,31583403,59.4603557501,18.7715745242,19.106236568,17,0,0,
The Prisoner of Zenda,2874,12500000,7000000,7000000,-5500000,-5500000,59.4603557501,18.4689969102,19.0958743239,41,0,0,
Conviction,2875,12500000,6783129,10118985,-5716871,-2381015,59.4603557501,18.4982825706,19.0947697151,22,0,0,
Lars and the Real Girl,2876,12500000,5956480,11277119,-6543520,-1222881,59.4603557501,18.5089421486,19.0905480437,61,0,0,
Solitary Man,2877,12500000,4360548,4360548,-8139452,-8139452,59.4603557501,18.4435256996,19.0823469014,88,0,0,
Dancer in the Dark,2878,12500000,4157491,45557491,-8342509,33057491,59.4603557501,18.7818994803,19.0812985965,17,0,0,
Casino Jack,2879,12500000,2039869,2272186,-10460131,-10227814,59.4603557501,18.422902554,19.0703001373,51,0,0,
Oscar and Lucinda,2880,12500000,1508689,1508689,-10991311,-10991311,59.4603557501,18.4152553633,19.0675222241,23,0,0,
Tae Guik Gi: The Brotherhood of War,2881,12500000,1110186,69826708,-11389814,57326708,59.4603557501,18.9381459767,19.065433094,54,0,0,
The Funeral,2882,12500000,1106233,1306233,-11393767,-11193767,59.4603557501,18.4132177148,19.0654123487,9,0,0,
The Perfect Game,2883,12500000,1089445,3931367,-11410555,-8568633,59.4603557501,18.4393220011,19.0653242409,50,0,0,
Ernest et Celestine,2884,12500000,292562,9376444,-12207438,-3123556,59.4603557501,18.4913878813,19.0611330326,25,0,0,
The Land Before Time,2885,12300000,48092846,81972846,35792846,69672846,59.2210738112,19.0091509974,19.2866636621,88,0,0,
Jaws,2886,12000000,260000000,470700000,248000000,458700000,58.8566191277,20.1596550029,19.9246277345,73,0,0,
The Exorcist,2887,12000000,204868002,402735134,192868002,390735134,58.8566191277,20.0324866026,19.7939134798,29,0,0,
The Fault in Our Stars,2888,12000000,124872350,303572350,112872350,291572350,58.8566191277,19.812018844,19.5674915012,3,0,0,
American Pie,2889,12000000,101800948,234723148,89800948,222723148,58.8566191277,19.6241736032,19.4913813301,9,0,0,
Think Like a Man,2890,12000000,91547205,96155124,79547205,84155124,58.8566191277,19.0864843019,19.4556022445,89,0,0,
Heaven is for Real,2891,12000000,91386097,100919111,79386097,88919111,58.8566191277,19.1106697076,19.4550297376,92,0,0,
Star Trek II: The Wrath of Khan,2892,12000000,78633541,95520578,66633541,83520578,58.8566191277,19.0832182934,19.4086402487,99,0,0,
The Golden Child,2893,12000000,77559863,77559863,65559863,65559863,58.8566191277,18.9860519662,19.4046345505,87,0,0,
Barbershop,2894,12000000,75781642,77063461,63781642,65063461,58.8566191277,18.9832276777,19.3979648316,84,0,0,
WarGames,2895,12000000,74433837,74433837,62433837,62433837,58.8566191277,18.9681318643,19.3928797054,83,0,0,
Ace Ventura: Pet Detective,2896,12000000,71602138,106602138,59602138,94602138,58.8566191277,19.1387760167,19.3821110189,17,0,0,
Act of Valor,2897,12000000,70012847,82497035,58012847,70497035,58.8566191277,19.0137162596,19.3760158966,62,0,0,
Witness,2898,12000000,65532576,65532576,53532576,53532576,58.8566191277,18.9152722121,19.358630798,28,0,0,
Step Up,2899,12000000,65328121,110989157,53328121,98989157,58.8566191277,19.1599449906,19.3578301806,96,0,0,
Chronicle,2900,12000000,64575175,123681790,52575175,111681790,58.8566191277,19.2187825018,19.3548762092,29,0,0,
Beavis and Butt-head Do America,2901,12000000,63071133,63071133,51071133,51071133,58.8566191277,18.9001480449,19.3489492708,34,0,0,
Patton,2902,12000000,62500000,62500000,50500000,50500000,58.8566191277,18.8966058193,19.3466893876,45,0,0,
Project X,2903,12000000,54731865,103028188,42731865,91028188,58.8566191277,19.1211928865,19.3154339434,46,0,0,
Jackie Brown,2904,12000000,39647595,74701925,27647595,62701925,58.8566191277,18.969681344,19.251800946,31,0,0,
Yentl,2905,12000000,39012241,39012241,27012241,27012241,58.8566191277,18.738861587,19.249029755,75,0,0,
Harold & Kumar Escape from Guantanamo Bay,2906,12000000,38108728,43353117,26108728,31353117,58.8566191277,18.7699518601,19.245075676,34,0,0,
Philomena,2907,12000000,37709979,98963392,25709979,86963392,58.8566191277,19.1008117505,19.2433256303,92,0,0,
Time Bandits,2908,12000000,37400000,37400000,25400000,25400000,58.8566191277,18.7270636753,19.2419630629,29,0,0,
Quarantine,2910,12000000,31691811,41924774,19691811,29924774,58.8566191277,18.7598280851,19.2165340143,31,0,0,
One Hour Photo,2911,12000000,31597131,52223306,19597131,40223306,58.8566191277,18.8306261207,19.2161067306,23,0,0,
The Eye,2912,12000000,31418697,57577765,19418697,45577765,58.8566191277,18.8655460812,19.2153009748,33,0,0,
Johnson Family Vacation,2913,12000000,31203964,31286759,19203964,19286759,58.8566191277,18.6810198901,19.2143304417,81,0,0,
How High,2914,12000000,31155435,31222395,19155435,19222395,58.8566191277,18.6805236556,19.2141109737,2,0,0,
Spartacus,2915,12000000,30000000,60000000,18000000,48000000,58.8566191277,18.8809511715,19.2088713461,96,0,0,
Crank,2916,12000000,27838408,43924923,15838408,31924923,58.8566191277,18.7739761387,19.1989946926,59,0,0,
The Muppet Christmas Carol,2917,12000000,27281507,27281507,15281507,15281507,58.8566191277,18.6496612193,19.1964342418,8,0,0,
Frida,2918,12000000,25885000,56131239,13885000,44131239,58.8566191277,18.8562319005,19.1899845728,42,0,0,
Katy Perry: Part of Me,2919,12000000,25326071,32700439,13326071,20700439,58.8566191277,18.6918574569,19.1873914971,75,0,0,
Top Five,2920,12000000,25317379,25514848,13317379,13514848,58.8566191277,18.6355105518,19.1873511186,100,0,0,
Rounders,2921,12000000,22905674,22905674,10905674,10905674,58.8566191277,18.6142382406,19.1760841323,70,0,0,
Casino Royale,2922,12000000,22744718,41744718,10744718,29744718,58.8566191277,18.7585445833,19.175327641,12,0,0,
Prophecy,2923,12000000,22673340,22673340,10673340,10673340,58.8566191277,18.6123219213,19.174991982,16,0,0,
Project Almanac,2924,12000000,22348241,32248241,10348241,20248241,58.8566191277,18.6884035719,19.1734617592,63,0,0,
Just Wright,2925,12000000,21524012,21851314,9524012,9851314,58.8566191277,18.6055121153,19.1695716329,83,0,0,
A Stir of Echoes,2926,12000000,21133087,21133087,9133087,9133087,58.8566191277,18.5995240002,19.1677212739,89,0,0,
Tales from the Crypt: Demon Knight,2927,12000000,20943520,20943520,8943520,8943520,58.8566191277,18.5979375131,19.1668227652,73,0,0,
The Boys from Brazil,2928,12000000,19000000,19000000,7000000,7000000,58.8566191277,18.5815253296,19.1575640098,28,0,0,
The Upside of Anger,2929,12000000,18761993,28915761,6761993,16915761,58.8566191277,18.6625754131,19.1564242512,19,0,0,
Aquamarine,2930,12000000,18595716,22977327,6595716,10977327,58.8566191277,18.6148285031,19.155627219,20,0,0,
Nebraska,2931,12000000,17654912,24761360,5654912,12761360,58.8566191277,18.6294137768,19.1511055637,32,0,0,
My Baby's Daddy,2932,12000000,17321573,17322212,5321573,5322212,58.8566191277,18.5671372192,19.1494985648,99,0,0,
Max Keeble's Big Move,2933,12000000,17292381,17292381,5292381,5292381,58.8566191277,18.5668795168,19.1493577096,11,0,0,
Young Adult,2934,12000000,16311571,22750356,4311571,10750356,58.8566191277,18.6129575657,19.1446136049,76,0,0,
About Time,2935,12000000,15323921,89177486,3323921,77177486,58.8566191277,19.0499703875,19.1398135642,60,0,0,
Def Jam's How To Be a Player,2936,12000000,14008431,14008431,2008431,2008431,58.8566191277,18.5380963611,19.1333842078,71,0,0,
Living Out Loud,2937,12000000,12902790,12902790,902790,902790,58.8566191277,18.5282161808,19.1279483159,13,0,0,
Rachel Getting Married,2938,12000000,12796861,17475475,796861,5475475,58.8566191277,18.5684601733,19.1274259608,39,0,0,
The Postman Always Rings Twice,2939,12000000,12200000,44200000,200000,32200000,58.8566191277,18.7759063322,19.1244776197,89,0,0,
Girl with a Pearl Earring,2940,12000000,11634362,43281552,-365638,31281552,58.8566191277,18.769447055,19.1216754669,31,0,0,
Das Boot,2941,12000000,11433134,84915795,-566866,72915795,58.8566191277,19.0269949153,19.1206766931,76,0,0,
House of Flying Daggers,2942,12000000,11050094,92863945,-949906,80863945,58.8566191277,19.0694275927,19.1187727537,79,0,0,
Sorority Boys,2943,12000000,10198766,12516222,-1801234,516222,58.8566191277,18.5247385876,19.1145281144,97,0,0,
Cadillac Records,2944,12000000,8138000,8138000,-3862000,-3862000,58.8566191277,18.4844837635,19.1041781196,17,0,0,
Arbitrage,2945,12000000,7919574,35830713,-4080426,23830713,58.8566191277,18.7154448421,19.1030747913,73,0,0,
The Alamo,2946,12000000,7900000,7900000,-4100000,-4100000,58.8566191277,18.4822483752,19.1029758583,45,0,0,
Screwed,2947,12000000,6982680,6982680,-5017320,-5017320,58.8566191277,18.4735854983,19.0983284306,33,0,0,
Running With Scissors,2948,12000000,6860000,8706701,-5140000,-3293299,58.8566191277,18.4898050749,19.097705255,65,0,0,
Fortress,2949,12000000,6730578,46730578,-5269422,34730578,58.8566191277,18.793490558,19.097047411,93,0,0,
For Greater Glory,2950,12000000,5669081,10026255,-6330919,-1973745,58.8566191277,18.5020440901,19.0916354942,11,0,0,
For Your Consideration,2951,12000000,5549923,5549923,-6450077,-6450077,58.8566191277,18.4599030437,19.0910261487,2,0,0,
Celebrity,2952,12000000,5032496,6153836,-6967504,-5846164,58.8566191277,18.4656930955,19.0883758358,52,0,0,
From Justin to Kelly,2953,12000000,4922166,4922166,-7077834,-7077834,58.8566191277,18.4538486373,19.0878098048,19,0,0,
Invaders from Mars,2954,12000000,4884663,4984663,-7115337,-7015337,58.8566191277,18.4544530357,19.0876173284,38,0,0,
Girl 6,2955,12000000,4855000,4855000,-7145000,-7145000,58.8566191277,18.4531986783,19.087465063,79,0,0,
In the Cut,2956,12000000,4717455,23693646,-7282545,11693646,58.8566191277,18.6207103177,19.0867587171,49,0,0,
Charlie Bartlett,2957,12000000,3950294,5295909,-8049706,-6704091,58.8566191277,18.4574576177,19.0828098754,97,0,0,
Two Lovers,2958,12000000,3149034,16349034,-8850966,4349034,58.8566191277,18.5586957353,19.078668798,31,0,0,
Last Orders,2959,12000000,2326407,2326407,-9673593,-9673593,58.8566191277,18.4284172301,19.0743993754,9,0,0,
Gwoemul,2960,12000000,2201923,92618117,-9798077,80618117,58.8566191277,19.0681418226,19.0737517144,77,0,0,
The Pursuit of D.B. Cooper,2961,12000000,2104164,2104164,-9895836,-9895836,58.8566191277,18.4262094923,19.073242803,23,0,0,
Ravenous,2962,12000000,2062406,2062406,-9937594,-9937594,58.8566191277,18.4257941284,19.0730253413,12,0,0,
The Dangerous Lives of Altar Boys,2963,12000000,1779284,1779284,-10220716,-10220716,58.8566191277,18.422973374,19.0715496879,69,0,0,
Stoker,2964,12000000,1703125,9379873,-10296875,-2620127,58.8566191277,18.4960675374,19.0711523695,29,0,0,
Married Life,2965,12000000,1506998,1506998,-10493002,-10493002,58.8566191277,18.4202530526,19.0701284555,54,0,0,
2046,2966,12000000,1442337,19287484,-10557663,7287484,58.8566191277,18.5839700477,19.069790652,51,0,0,
Duma,2967,12000000,860002,984725,-11139998,-11015275,58.8566191277,18.4150143906,19.066743251,83,0,0,
Darling Companion,2968,12000000,793352,1200346,-11206648,-10799654,58.8566191277,18.4171805054,19.0663938737,70,0,0,
Ondine,2969,12000000,550472,550472,-11449528,-11449528,58.8566191277,18.4106376203,19.0651196703,60,0,0,
Brother,2970,12000000,450594,450594,-11549406,-11549406,58.8566191277,18.4096282496,19.0645952162,66,0,0,
Welcome to Collinwood,2971,12000000,378650,378650,-11621350,-11621350,58.8566191277,18.4089005492,19.0642172716,11,0,0,
Life Before Her Eyes,2972,12000000,303439,7203439,-11696561,-4796561,58.8566191277,18.475677143,19.0638220117,74,0,0,
Critical Care,2973,12000000,218158,218158,-11781842,-11781842,58.8566191277,18.4072752911,19.0633736413,83,0,0,
Trade,2974,12000000,214202,1513388,-11785798,-10486612,58.8566191277,18.4203169779,19.0633528375,47,0,0,
Fateless,2975,12000000,196857,196857,-11803143,-11803143,58.8566191277,18.4070593831,19.0632616185,86,0,0,
San qiang pai an jing qi,2976,12000000,190946,310946,-11809054,-11689054,58.8566191277,18.4082152516,19.0632305301,43,0,0,
Breakfast of Champions,2977,12000000,178287,178287,-11821713,-11821713,58.8566191277,18.4068711186,19.0631639479,3,0,0,
Company Man,2978,12000000,146028,622273,-11853972,-11377727,58.8566191277,18.4113626148,19.0629942561,89,0,0,
Nanjing! Nanjing!,2979,12000000,122558,20122558,-11877442,8122558,58.8566191277,18.591037676,19.0628707789,80,0,0,
Trash,2980,12000000,17484,6553186,-11982516,-5446814,58.8566191277,18.4695035553,19.0623177909,89,0,0,
5 Days of War,2981,12000000,17479,17479,-11982521,-11982521,58.8566191277,18.405239347,19.0623177646,24,0,0,
10 Days in a Madhouse,2982,12000000,14616,14616,-11985384,-11985384,58.8566191277,18.405210271,19.0623026928,19,0,0,
Diamonds,2989,11900000,81897,81897,-11818103,-11818103,58.7336161166,18.4069077199,19.0631829358,33,0,0,
Madadayo,2990,11900000,48856,48856,-11851144,-11851144,58.7336161166,18.4065726716,19.0630091334,4,0,0,
Pet Sematary,2991,11500000,52795778,52795778,41295778,41295778,58.2337100962,18.8377187603,19.3095472417,11,0,0,
St. Trinian's,2993,11400000,15000,29830239,-11385000,18430239,58.1067001578,18.6743960291,19.0654583572,88,0,0,
Star Wars Ep. IV: A New Hope,2994,11000000,460935665,786535665,449935665,775535665,57.5901449065,20.6022116021,20.2953664303,98,0,0,
Gremlins,2995,11000000,148117285,148117285,137117285,137117285,57.5901449065,19.3271939392,19.6416835295,82,0,0,
Doctor Zhivago,2996,11000000,111721000,111745581,100721000,100745581,57.5901449065,19.1682963322,19.5281282899,32,0,0,
The Fighter,2997,11000000,93617009,129262388,82617009,118262388,57.5901449065,19.2479768827,19.4664488169,38,0,0,
High School Musical 3: Senior Year,2998,11000000,90559416,274392880,79559416,263392880,57.5901449065,19.7393468075,19.4556456237,4,0,0,
Jackass: Number Two,2999,11000000,72778712,85278712,61778712,74278712,57.5901449065,19.0344001953,19.3903986174,0,0,0,
My Cousin Vinny,3000,11000000,52929168,52929168,41929168,41929168,57.5901449065,18.8418840872,19.3121478596,4,0,0,
If I Stay,3001,11000000,50474843,78874843,39474843,67874843,57.5901449065,18.9991187628,19.3020328238,6,0,0,
Major League,3002,11000000,49793054,49793054,38793054,38793054,57.5901449065,18.8210883914,19.2992047052,23,0,0,
Phone Booth,3003,11000000,46566212,97837138,35566212,86837138,57.5901449065,19.1001720055,19.2857098989,49,0,0,
A Walk to Remember,3004,11000000,41227069,46060915,30227069,35060915,57.5901449065,18.7957633221,19.2629734854,16,0,0,
Dead Man Walking,3005,11000000,39379757,83080768,28379757,72080768,57.5901449065,19.0224306344,19.2549848847,17,0,0,
Cruel Intentions,3006,11000000,38201895,75775536,27201895,64775536,57.5901449065,18.9815858604,19.2498577635,84,0,0,
The Secret Life of Bees,3007,11000000,37770162,39984023,26770162,28984023,57.5901449065,18.7531038296,19.2479718677,41,0,0,
Woman in Gold,3008,11000000,33307793,55766926,22307793,44766926,57.5901449065,18.8603357782,19.228268108,28,0,0,
History of the World: Part I,3009,11000000,31672000,31672000,20672000,20672000,57.5901449065,18.6916405912,19.2209468378,22,0,0,
Saw VI,3010,11000000,27693292,69752402,16693292,58752402,57.5901449065,18.9466076316,19.2029124607,7,0,0,
Corky Romano,3011,11000000,23978402,25116103,12978402,14116103,57.5901449065,18.6403490236,19.185775135,58,0,0,
Raising Cain,3012,11000000,21171695,21171695,10171695,10171695,57.5901449065,18.6081717246,19.172629785,71,0,0,
F.I.S.T,3013,11000000,20388920,20388920,9388920,9388920,57.5901449065,18.6016610851,19.1689325912,12,0,0,
Barry Lyndon,3014,11000000,20000000,20000000,9000000,9000000,57.5901449065,18.5984104578,19.1670905533,34,0,0,
Quartet,3015,11000000,18388357,56178935,7388357,45178935,57.5901449065,18.862986665,19.1594209739,83,0,0,
Out Cold,3016,11000000,13906394,14786394,2906394,3786394,57.5901449065,18.5537826094,19.1377774074,17,0,0,
The Ladies Man,3017,11000000,13592872,13719474,2592872,2719474,57.5901449065,18.5443991615,19.1362457225,33,0,0,
Tomcats,3018,11000000,13558739,13558739,2558739,2558739,57.5901449065,18.5429778515,19.1360788269,84,0,0,
Inside Llewyn Davis,3019,11000000,13248209,32943247,2248209,21943247,57.5901449065,18.7012890236,19.1345591892,51,0,0,
Frailty,3020,11000000,13110448,19947280,2110448,8947280,57.5901449065,18.597969005,19.1338842893,28,0,0,
Army of Darkness,3021,11000000,11502976,21502976,502976,10502976,57.5901449065,18.6109144008,19.1259753302,77,0,0,
Kinsey,3022,11000000,10214647,13000959,-785353,2000959,57.5901449065,18.5380299167,19.1195911254,29,0,0,
What's Eating Gilbert Grape,3023,11000000,9170214,9170214,-1829786,-1829786,57.5901449065,18.5033703088,19.1143854441,35,0,0,
Slackers,3024,11000000,4814244,4814244,-6185756,-6185756,57.5901449065,18.4624413635,19.0923773216,77,0,0,
The Gospel of John,3025,11000000,4068087,4234355,-6931913,-6765645,57.5901449065,18.456864128,19.0885583616,80,0,0,
Vera Drake,3026,11000000,3753806,13353855,-7246194,2353855,57.5901449065,18.5411632174,19.0869454418,81,0,0,
The Guru,3027,11000000,3051221,24150550,-7948779,13150550,57.5901449065,18.6325675108,19.083330273,68,0,0,
Othello,3028,11000000,2844379,2844379,-8155621,-8155621,57.5901449065,18.443367649,19.0822634673,19,0,0,
The Perez Family,3029,11000000,2669359,2669359,-8330641,-8330641,57.5901449065,18.4416552433,19.0813598966,43,0,0,
The Molly Maguires,3030,11000000,2200000,2200000,-8800000,-8800000,57.5901449065,18.4370484789,19.0789327121,43,0,0,
Return to the Blue Lagoon,3031,11000000,2000000,2000000,-9000000,-9000000,57.5901449065,18.4350790097,19.0778966644,84,0,0,
Romance and Cigarettes,3032,11000000,551002,3231251,-10448998,-7768749,57.5901449065,18.4471424543,19.0703582771,81,0,0,
Copying Beethoven,3033,11000000,355968,355968,-10644032,-10644032,57.5901449065,18.4187409639,19.0693392629,76,0,0,
Brighton Rock,3034,11000000,224631,224631,-10775369,-10775369,57.5901449065,18.4174241772,19.0686524675,82,0,0,
Le prénom,3035,11000000,61611,25307405,-10938389,14307405,57.5901449065,18.6418835894,19.0677993367,74,0,0,
Saw V,3038,10800000,56746769,118209778,45946769,107409778,57.3265675323,19.1993633045,19.3284879523,5,0,0,
Jindabyne,3039,10800000,399879,2862544,-10400121,-7937456,57.3265675323,18.4454980903,19.0706134871,13,0,0,
Kabhi Alvida Naa Kehna,3040,10750000,3275443,32575443,-7474557,21825443,57.260101835,18.7003988254,19.0857718273,35,0,0,
Poltergeist,3041,10700000,74706019,121706019,64006019,111006019,57.1934038746,19.2157356607,19.3988088773,47,0,0,
An Ideal Husband,3042,10700000,18542974,31341183,7842974,20641183,57.1934038746,18.6914055386,19.1615903942,65,0,0,
Darkness,3043,10600000,22163442,34409206,11563442,23809206,57.059303529,18.7152846651,19.1791696996,59,0,0,
The Last Days on Mars,3044,10600000,24084,261364,-10575916,-10338636,57.059303529,18.4217961817,19.0696952736,7,0,0,
ET: The Extra-Terrestrial,3045,10500000,434949459,792804231,424449459,782304231,56.9242509762,20.6098221548,20.2554849835,80,0,0,
2001: A Space Odyssey,3046,10500000,56700000,68700000,46200000,58200000,56.9242509762,18.9433375545,19.3295089846,17,0,0,
In the Land of Women,3047,10500000,11052958,14140402,552958,3640402,56.9242509762,18.5525038133,19.1262221923,48,0,0,
There Goes My Baby,3048,10500000,125169,125169,-10374831,-10374831,56.9242509762,18.4214345699,19.0707455126,76,0,0,
The Blue Butterfly,3049,10400000,1610194,1610194,-8789806,-8789806,56.7882302887,18.4371487589,19.0789854907,72,0,0,
Le Fabuleux destin d'Amélie Poulain,3050,10350000,33201661,174201661,22851661,163851661,56.7198518019,19.4297398936,19.2306904567,43,0,0,
Lovesick,3051,10100000,10143618,10143618,43618,43618,56.3741937097,18.5204705119,19.1237036932,92,0,0,
Housefull,3052,10100000,1183658,18726300,-8916342,8626300,56.3741937097,18.5952770545,19.0783301634,42,0,0,
September Dawn,3053,10100000,1066555,1066555,-9033445,-9033445,56.3741937097,18.4347492864,19.0777233065,32,0,0,
Good Will Hunting,3054,10000000,138339411,225839411,128339411,215839411,56.234132519,19.603296051,19.6154535538,95,0,0,
The Grudge,3055,10000000,110175871,187097624,100175871,177097624,56.234132519,19.4768998948,19.5263255531,47,0,0,
Stripes,3056,10000000,83339362,83339362,73339362,73339362,56.234132519,19.0293022049,19.4333018006,72,0,0,
Saw III,3057,10000000,80238724,163876815,70238724,153876815,56.234132519,19.3926977467,19.4219743355,82,0,0,
Bring it On,3058,10000000,68353550,90453550,58353550,80453550,56.234132519,19.0672801524,19.3773256656,33,0,0,
She's All That,3059,10000000,63319509,63319509,53319509,53319509,56.234132519,18.9139720421,19.3577964431,7,0,0,
Saw IV,3060,10000000,63300095,135759694,53300095,125759694,56.234132519,19.2802315269,19.3577203847,100,0,0,
Madea's Family Reunion,3061,10000000,63257940,63320521,53257940,53320521,56.234132519,18.9139782214,19.3575552137,69,0,0,
White Noise,3062,10000000,55865715,91865715,45865715,81865715,56.234132519,19.0746501869,19.3281609207,7,0,0,
Insidious Chapter 3,3063,10000000,52218558,120678444,42218558,110678444,56.234132519,19.2142553797,19.3133338105,65,0,0,
The Color of Money,3064,10000000,50159778,50159778,40159778,40159778,56.234132519,18.830204405,19.3048659614,57,0,0,
The Mighty Ducks,3065,10000000,49764659,49764659,39764659,39764659,56.234132519,18.8275775002,19.3032325868,45,0,0,
Precious (Based on the Novel Push by Sapphire),3066,10000000,47566524,68722848,37566524,58722848,56.234132519,18.94643295,19.2940967301,44,0,0,
The Best Exotic Marigold Hotel,3067,10000000,46383639,134639780,36383639,124639780,56.234132519,19.2754790711,19.2891456785,77,0,0,
The Longest Day,3068,10000000,39100000,50100000,29100000,40100000,56.234132519,18.8298074204,19.2581071313,11,0,0,
Happy Gilmore,3069,10000000,38602000,40982952,28602000,30982952,56.234132519,18.7673380364,19.2559493464,83,0,0,
Jeepers Creepers,3070,10000000,37904175,58939035,27904175,48939035,56.234132519,18.8868600511,19.2529178847,77,0,0,
Bill & Ted's Excellent Adventure,3071,10000000,37788317,37788317,27788317,27788317,56.234132519,18.7444914391,19.2524136885,10,0,0,
Oliver!,3072,10000000,37402877,37402877,27402877,27402877,56.234132519,18.7416993213,19.2507344812,69,0,0,
Recess: School's Out,3073,10000000,36696761,44451470,26696761,34451470,56.234132519,18.7915662223,19.2476508834,0,0,0,
Mad Max Beyond Thunderdome,3074,10000000,36230219,36230219,26230219,26230219,56.234132519,18.7331563581,19.2456082725,46,0,0,
Pete's Dragon,3075,10000000,36000000,36000000,26000000,26000000,56.234132519,18.7314705787,19.2445987898,79,0,0,
Commando,3076,10000000,34896317,34896317,24896317,24896317,56.234132519,18.7233491508,19.2397450685,98,0,0,
Devil,3077,10000000,33601190,63275649,23601190,53275649,56.234132519,18.9137041912,19.234019218,95,0,0,
Friday After Next,3078,10000000,33253609,33526835,23253609,23526835,56.234132519,18.7131792762,19.2324769407,84,0,0,
The Last Dragon,3079,10000000,33000000,33000000,23000000,23000000,56.234132519,18.7092392473,19.2313501306,55,0,0,
The Lawnmower Man,3080,10000000,32100816,32100816,22100816,22100816,56.234132519,18.7024784726,19.2273447038,40,0,0,
Nick and Norah's Infinite Playlist,3081,10000000,31487293,33886017,21487293,23886017,56.234132519,18.7158566102,19.2246025206,14,0,0,
Dogma,3082,10000000,30651422,43948865,20651422,33948865,56.234132519,18.7880916003,19.2208543952,0,0,0,
The Banger Sisters,3083,10000000,30306281,38067218,20306281,28067218,56.234132519,18.7465069407,19.2193026427,36,0,0,
Snatch,3084,10000000,30093107,83593107,20093107,73593107,56.234132519,19.0306818803,19.2183430089,80,0,0,
Road House,3085,10000000,30050028,30050028,20050028,20050028,56.234132519,18.6868858538,19.2181489707,9,0,0,
Twilight Zone: The Movie,3086,10000000,29450919,29450919,19450919,19450919,56.234132519,18.6822844193,19.215446528,98,0,0,
A Low Down Dirty Shame,3087,10000000,29097256,29097256,19097256,19097256,56.234132519,18.6795581519,19.2138478009,5,0,0,
One Direction: This is Us,3088,10000000,28873374,68541786,18873374,58541786,56.234132519,18.9453621002,19.2128344236,68,0,0,
Swimfan,3089,10000000,28564995,34364995,18564995,24364995,56.234132519,18.7194157843,19.2114368965,23,0,0,
Employee of the Month,3090,10000000,28444855,38364855,18444855,28364855,56.234132519,18.7486533682,19.210891911,92,0,0,
Sinister 2,3091,10000000,27740955,52650204,17740955,42650204,56.234132519,18.8466047738,19.2076928605,75,0,0,
The Fourth Kind,3092,10000000,26218170,49486874,16218170,39486874,56.234132519,18.8257265376,19.2007369634,48,0,0,
The Outsiders,3093,10000000,25584680,25584680,15584680,15584680,56.234132519,18.6520695853,19.1978289462,69,0,0,
Can't Hardly Wait,3094,10000000,25339117,25339117,15339117,15339117,56.234132519,18.6501193121,19.1966994182,52,0,0,
Sparkle,3095,10000000,24397469,24660323,14397469,14660323,56.234132519,18.6447084244,19.1923562091,33,0,0,
Mud,3096,10000000,21590086,31556959,11590086,21556959,56.234132519,18.6983670322,19.1792944852,6,0,0,
Skyline,3097,10000000,21393620,78670636,11393620,68670636,56.234132519,19.003571432,19.1783739816,14,0,0,
Valentine,3098,10000000,20384136,20384136,10384136,10384136,56.234132519,18.6099313892,19.17363083,66,0,0,
A Prairie Home Companion,3099,10000000,20342852,26716191,10342852,16716191,56.234132519,18.6610072826,19.1734363738,12,0,0,
Reno 911!: Miami,3100,10000000,20342161,21851362,10342161,11851362,56.234132519,18.6220007159,19.1734331187,45,0,0,
Jane Austen's Mafia,3101,10000000,19843795,30143795,9843795,20143795,56.234132519,18.6876041153,19.1710827149,91,0,0,
The Dead Zone,3102,10000000,19287938,19287938,9287938,9287938,56.234132519,18.6008180838,19.1684546372,67,0,0,
Sugar Hill,3103,10000000,18219465,18219465,8219465,8219465,56.234132519,18.5918546207,19.1633834434,65,0,0,
Kit Kittredge: An American Girl,3104,10000000,17657973,17657973,7657973,7657973,56.234132519,18.5871118385,19.1607081421,38,0,0,
Invasion U.S.A.,3105,10000000,17536256,17536256,7536256,7536256,56.234132519,18.5860807522,19.1601272606,14,0,0,
Roll Bounce,3106,10000000,17380866,17433072,7380866,7433072,56.234132519,18.5852058289,19.1593851876,98,0,0,
Rushmore,3107,10000000,17096053,19071269,7096053,9071269,56.234132519,18.5990069216,19.158023617,24,0,0,
Tremors,3108,10000000,16667084,16667084,6667084,6667084,56.234132519,18.5786867767,19.1559693922,4,0,0,
The Perfect Man,3109,10000000,16247775,19247775,6247775,9247775,56.234132519,18.6004826041,19.1539573401,10,0,0,
Mo' Better Blues,3110,10000000,16153000,16153000,6153000,6153000,56.234132519,18.574287636,19.1535020013,39,0,0,
Kung Pow: Enter the Fist,3111,10000000,16033556,17033556,6033556,7033556,56.234132519,18.5818109928,19.1529278468,77,0,0,
Wrong Turn,3112,10000000,15417771,28649556,5417771,18649556,56.234132519,18.6760962912,19.1499625923,55,0,0,
The Long Riders,3113,10000000,15198912,15198912,5198912,5198912,56.234132519,18.5660716315,19.148906576,55,0,0,
The Corruptor,3114,10000000,15164492,15164492,5164492,5164492,56.234132519,18.5657739629,19.1487403946,34,0,0,
"The Goods: Live Hard, Sell Hard",3115,10000000,15122676,15297318,5122676,5297318,56.234132519,18.5669221709,19.1485384677,51,0,0,
My Week with Marilyn,3116,10000000,14597405,34240572,4597405,24240572,56.234132519,18.7184924431,19.1459984879,12,0,0,
Big Eyes,3117,10000000,14482031,15875318,4482031,5875318,56.234132519,18.5719033699,19.1454397248,3,0,0,
Hey Arnold! The Movie,3118,10000000,13684949,13684949,3684949,3684949,56.234132519,18.5528941898,19.1415708558,82,0,0,
The Matador,3119,10000000,12589255,17300838,2589255,7300838,56.234132519,18.5840834629,19.1362280382,40,0,0,
Love Jones,3120,10000000,12514138,12514138,2514138,2514138,56.234132519,18.5425831058,19.1358607054,99,0,0,
End of the Spear,3122,10000000,11748661,11924041,1748661,1924041,56.234132519,18.5373456704,19.1321096999,90,0,0,
Get Over It,3123,10000000,11560259,19860259,1560259,9860259,56.234132519,18.6055864673,19.131184327,48,0,0,
Office Space,3124,10000000,10824921,12176816,824921,2176816,56.234132519,18.5395925468,19.1275643563,2,0,0,
Drop Dead Gorgeous,3125,10000000,10571408,10571408,571408,571408,56.234132519,18.5252357854,19.1263133018,55,0,0,
Le Violon rouge,3126,10000000,10019109,10019109,19109,19109,56.234132519,18.520248674,19.1235823451,11,0,0,
Very Bad Things,3127,10000000,9801782,20947286,-198218,10947286,56.234132519,18.614581074,19.1225056787,13,0,0,
Sleepover,3128,10000000,9408183,9408183,-591817,-591817,56.234132519,18.5147030494,19.1205527819,16,0,0,
Movie 43,3129,10000000,8840453,31164747,-1159547,21164747,56.234132519,18.6953914686,19.1177291748,66,0,0,
Body Double,3130,10000000,8801940,8801940,-1198060,-1198060,56.234132519,18.5091693644,19.1175373412,37,0,0,
MacGruber,3131,10000000,8525600,8629895,-1474400,-1370105,56.234132519,18.507593372,19.1161598086,54,0,0,
Dirty Pretty Things,3132,10000000,8112414,14156753,-1887586,4156753,56.234132519,18.5570193989,19.1140965635,78,0,0,
Bad Words,3133,10000000,7779614,7843145,-2220386,-2156855,56.234132519,18.5003546483,19.1124316252,48,0,0,
While We're Young,3134,10000000,7582065,13422414,-2417935,3422414,56.234132519,18.5505913294,19.1114420105,68,0,0,
Over Her Dead Body,3135,10000000,7563670,21589617,-2436330,11589617,56.234132519,18.6198582625,19.1113498116,89,0,0,
Bones,3136,10000000,7316658,8378853,-2683342,-1621147,56.234132519,18.505289274,19.1101109201,23,0,0,
Seeking a Friend for the End of the World,3137,10000000,7078738,7756163,-2921262,-2243837,56.234132519,18.4995511187,19.1089161767,93,0,0,
Turistas,3138,10000000,7027762,14321070,-2972238,4321070,56.234132519,18.5584521152,19.1086600089,89,0,0,
Cedar Rapids,3139,10000000,6861102,7862131,-3138898,-2137869,56.234132519,18.500529953,19.1078220403,80,0,0,
The Collection,3140,10000000,6810754,8396077,-3189246,-1603923,56.234132519,18.505447528,19.1075687517,34,0,0,
American History X,3141,10000000,6712241,6712241,-3287759,-3287759,56.234132519,18.4898567734,19.1070729711,39,0,0,
Teacher's Pet: The Movie,3142,10000000,6491350,6491350,-3508650,-3508650,56.234132519,18.4877933743,19.1059604117,41,0,0,
The Straight Story,3143,10000000,6197866,6197866,-3802134,-3802134,56.234132519,18.4850452625,19.1044803064,26,0,0,
Deuces Wild,3144,10000000,6044618,6244618,-3955382,-3755382,56.234132519,18.4854835428,19.103706571,46,0,0,
"Run, Fatboy, Run",3145,10000000,6003262,33512260,-3996738,23512260,56.234132519,18.713070483,19.1034976657,89,0,0,
Heartbeeps,3146,10000000,6000000,6000000,-4000000,-4000000,56.234132519,18.4831882228,19.1034811862,40,0,0,
Danny Collins,3147,10000000,5637066,7501132,-4362934,-2498868,56.234132519,18.4971914431,19.1016459598,94,0,0,
Rescue Dawn,3148,10000000,5484375,7031838,-4515625,-2968162,56.234132519,18.4928346941,19.1008728488,20,0,0,
Black and White,3149,10000000,5241315,5241315,-4758685,-4758685,56.234132519,18.4760355707,19.0996409436,7,0,0,
I am Love,3150,10000000,5005465,15132211,-4994535,5132211,56.234132519,18.5654947121,19.0984441284,80,0,0,
On the Line,3151,10000000,4365455,4690802,-5634545,-5309198,56.234132519,18.470813283,19.0951891773,99,0,0,
"Jeff, Who Lives at Home",3152,10000000,4269426,4708127,-5730574,-5291873,56.234132519,18.4709780481,19.0946998794,5,0,0,
Atlas Shrugged: Part II,3153,10000000,3336053,3336053,-6663947,-6663947,56.234132519,18.4578444873,19.0899315367,26,0,0,
Romeo Is Bleeding,3154,10000000,3275585,3275585,-6724415,-6724415,56.234132519,18.4572616973,19.0896218369,83,0,0,
The Limey,3155,10000000,3193102,6030047,-6806898,-3969953,56.234132519,18.4834704463,19.0891992278,6,0,0,
Rosewater,3157,10000000,3128941,3168858,-6871059,-6831142,56.234132519,18.4562322338,19.0888703696,65,0,0,
The House of Mirth,3158,10000000,3041803,5149131,-6958197,-4850869,56.234132519,18.4751629918,19.0884235692,48,0,0,
Malone,3159,10000000,3000000,3000000,-7000000,-7000000,56.234132519,18.4546013015,19.0882091533,58,0,0,
Bucky Larson: Born to Be a Star,3160,10000000,2529395,2529395,-7470605,-7470605,56.234132519,18.4500418277,19.0857921493,0,0,0,
Bamboozled,3161,10000000,2185266,2373937,-7814734,-7626063,56.234132519,18.4485310877,19.0840210146,45,0,0,
Sphinx,3162,10000000,2000000,11400000,-8000000,1400000,56.234132519,18.5326714096,19.0830662023,99,0,0,
The Iceman,3163,10000000,1930282,3623609,-8069718,-6376391,56.234132519,18.460611311,19.0827066578,60,0,0,
A Better Life,3164,10000000,1759252,1766372,-8240748,-8233628,56.234132519,18.4426047862,19.0818240866,6,0,0,
Spider,3165,10000000,1641788,1641788,-8358212,-8358212,56.234132519,18.4413852195,19.0812174822,3,0,0,
Gun Shy,3166,10000000,1638202,1638202,-8361798,-8361798,56.234132519,18.4413500937,19.0811989576,62,0,0,
Nicholas Nickleby,3167,10000000,1562800,1562800,-8437200,-8437200,56.234132519,18.4406112259,19.0808093674,84,0,0,
The Joneses,3168,10000000,1475746,3541565,-8524254,-6458435,56.234132519,18.4598226753,19.0803593843,23,0,0,
Krrish,3169,10000000,1430721,32430721,-8569279,22430721,56.234132519,18.7049642705,19.0801265701,31,0,0,
Killer Joe,3170,10000000,1291645,4659110,-8708355,-5340890,56.234132519,18.4705118139,19.0794070967,70,0,0,
Cecil B. Demented,3171,10000000,1276984,1953882,-8723016,-8046118,56.234132519,18.4444375433,19.0793312217,33,0,0,
Owning Mahowny,3172,10000000,1011054,1011054,-8988946,-8988946,56.234132519,18.4351879636,19.0779539548,99,0,0,
The Ten Commandments,3173,10000000,952820,1051907,-9047180,-8948093,56.234132519,18.4355905287,19.0776521042,27,0,0,
The Brothers Solomon,3174,10000000,900926,900926,-9099074,-9099074,56.234132519,18.4341019553,19.0773830396,56,0,0,
My Blueberry Nights,3175,10000000,866778,22198996,-9133222,12198996,56.234132519,18.6248391159,19.0772059466,52,0,0,
Illuminata,3176,10000000,836641,836641,-9163359,-9163359,56.234132519,18.4334674743,19.0770496287,68,0,0,
Coriolanus,3177,10000000,749641,1049641,-9250359,-8950359,56.234132519,18.4355682038,19.0765982304,54,0,0,
Swept Away,3178,10000000,598645,598645,-9401355,-9401355,56.234132519,18.4311149875,19.0758143058,70,0,0,
"War, Inc.",3179,10000000,578527,1297520,-9421473,-8702480,56.234132519,18.4380073871,19.0757098129,43,0,0,
Shaolin Soccer,3180,10000000,488872,42776032,-9511128,32776032,56.234132519,18.7799362734,19.0752440122,21,0,0,
The Brown Bunny,3181,10000000,366301,630427,-9633699,-9369573,56.234132519,18.4314294591,19.0746068458,31,0,0,
The Swindle,3182,10000000,245359,5045359,-9754641,-4954641,56.234132519,18.4741798134,19.0739777493,64,0,0,
La femme de chambre du Titanic,3183,10000000,244465,244465,-9755535,-9755535,56.234132519,18.4276037943,19.0739730976,32,0,0,
Imaginary Heroes,3184,10000000,228524,290875,-9771476,-9709125,56.234132519,18.4280645863,19.0738901484,5,0,0,
High Heels and Low Lifes,3185,10000000,226792,226792,-9773208,-9773208,56.234132519,18.4274282682,19.0738811355,72,0,0,
World's Greatest Dad,3186,10000000,221805,295750,-9778195,-9704250,56.234132519,18.4281129765,19.0738551839,59,0,0,
"Cinco de Mayo, La Batalla",3187,10000000,173472,173472,-9826528,-9826528,56.234132519,18.4268985136,19.0736036316,19,0,0,
Welcome to the Rileys,3188,10000000,152857,355919,-9847143,-9644081,56.234132519,18.4287100329,19.0734963202,59,0,0,
Free Style,3189,10000000,141108,721108,-9858892,-9278892,56.234132519,18.4323261721,19.0734351556,70,0,0,
Severance,3190,10000000,137221,5950002,-9862779,-4049998,56.234132519,18.4827184282,19.0734149193,38,0,0,
Edmond,3191,10000000,131719,241719,-9868281,-9758281,56.234132519,18.4275765234,19.0733862744,44,0,0,
Joheunnom nabbeunnom isanghannom,3192,10000000,128486,42226657,-9871514,32226657,56.234132519,18.7760931843,19.0733694421,34,0,0,
Police Academy 7: Mission to Moscow,3193,10000000,126247,126247,-9873753,-9873753,56.234132519,18.4264290807,19.0733577848,66,0,0,
Blood Done Sign My Name,3194,10000000,109383,109383,-9890617,-9890617,56.234132519,18.4262613932,19.0732699785,47,0,0,
The Good Guy,3195,10000000,100688,100688,-9899312,-9899312,56.234132519,18.4261749234,19.073224703,19,0,0,
Motherhood,3196,10000000,93388,723388,-9906612,-9276612,56.234132519,18.4323487078,19.0731866897,35,0,0,
Eulogy,3197,10000000,70527,70527,-9929473,-9929473,56.234132519,18.4258749209,19.0730676365,23,0,0,
Elsa & Fred,3198,10000000,67657,109144,-9932343,-9890856,56.234132519,18.4262590165,19.0730526894,16,0,0,
An Alan Smithee Film: Burn Hollywood Burn,3199,10000000,45779,45779,-9954221,-9954221,56.234132519,18.4256286927,19.0729387403,60,0,0,
The Open Road,3200,10000000,19716,19716,-9980284,-9980284,56.234132519,18.4253693155,19.0728029772,79,0,0,
Strangerland,3201,10000000,17472,20304,-9982528,-9979696,56.234132519,18.425375168,19.0727912872,0,0,0,
Hross i oss,3202,10000000,11894,11894,-9988106,-9988106,56.234132519,18.4252914584,19.0727622285,0,0,0,
Janky Promoters,3203,10000000,9069,9069,-9990931,-9990931,56.234132519,18.4252633379,19.0727475112,89,0,0,
Blonde Ambition,3204,10000000,6422,1537479,-9993578,-8462521,56.234132519,18.4403629817,19.0727337211,27,0,0,
The Oxford Murders,3205,10000000,4803,17704131,-9995197,7704131,56.234132519,18.5875025733,19.0727252865,77,0,0,
Barbecue,3206,10000000,388,14531,-9999612,-9985469,56.234132519,18.4253177067,19.072702285,35,0,0,
Gunless,3222,9900000,458054,458054,-9441946,-9441946,56.0930168961,18.4307132101,19.075603465,30,0,0,
Adventureland,3223,9800000,16044025,17553055,6244025,7753055,55.9508281306,18.587916556,19.1539393275,13,0,0,
Amour,3224,9700000,6738954,25915719,-2961046,16215719,55.807546985,18.657063951,19.1087162572,4,0,0,
The Lost City,3225,9600000,2484186,5256839,-7115814,-4343161,55.6631536743,18.4799593404,19.0876148801,80,0,0,
Next Friday,3226,9500000,57176582,59675307,47676582,50175307,55.5176278445,18.8945864316,19.3354419187,68,0,0,
You Only Live Twice,3227,9500000,43100000,111600000,33600000,102100000,55.5176278445,19.1746889514,19.2773969168,14,0,0,
Poltergeist III,3228,9500000,14114000,14114000,4614000,4614000,55.5176278445,18.5610011565,19.1460788328,6,0,0,
The Runaways,3229,9500000,3573673,5278632,-5926327,-4221368,55.5176278445,18.4811065132,19.0937017143,37,0,0,
Gentlemen Broncos,3230,9500000,113682,118482,-9386318,-9381518,55.5176278445,18.4313112792,19.0758924008,38,0,0,
It's a Mad Mad Mad Mad World,3232,9400000,46300000,60000000,36900000,50600000,55.3709485502,18.8972269364,19.2913099606,58,0,0,
Volver,3233,9400000,12899867,87226613,3499867,77826613,55.3709485502,19.0534240706,19.1406703612,64,0,0,
Melancholia,3234,9400000,3030848,21817298,-6369152,12417298,55.3709485502,18.6266174226,19.0914400202,60,0,0,
Heavy Metal,3235,9300000,19571091,19571091,10271091,10271091,55.2230942305,18.6089954145,19.1730982745,86,0,0,
Jab Tak Hai Jaan,3236,9200000,3047539,4074386,-6152461,-5125614,55.0740426846,18.472557834,19.0925473917,58,0,0,
Richard III,3237,9200000,2684904,4204857,-6515096,-4995143,55.0740426846,18.4737958185,19.0906935005,31,0,0,
Kites,3238,9200000,1685269,17155193,-7514731,7955193,55.0740426846,18.5896251832,19.0855652205,30,0,0,
Alien,3241,9000000,80930630,203630630,71930630,194630630,54.7722557505,19.5360874536,19.428171223,95,0,0,
Fiddler on the Roof,3242,9000000,80500000,80500000,71500000,71500000,54.7722557505,19.0192438121,19.4265976084,55,0,0,
The Purge: Anarchy,3244,9000000,71562550,111533636,62562550,102533636,54.7722557505,19.1767270307,19.3933664444,57,0,0,
Thunderball,3245,9000000,63600000,141200000,54600000,132200000,54.7722557505,19.3071316312,19.3628003052,94,0,0,
The Strangers,3246,9000000,52597610,83051676,43597610,74051676,54.7722557505,19.0331704171,19.3189660711,69,0,0,
Set It Off,3247,9000000,36049108,36049108,27049108,27049108,54.7722557505,18.7391297479,19.2491907659,31,0,0,
The Best Man,3248,9000000,34102780,34572780,25102780,25572780,54.7722557505,18.7283347089,19.2406548342,74,0,0,
Child's Play,3249,9000000,31605639,42557639,22605639,33557639,54.7722557505,18.7853785853,19.2295954193,84,0,0,
Sicko,3250,9000000,24538513,36535837,15538513,27535837,54.7722557505,18.7426633613,19.197616687,8,0,0,
Black or White,3251,9000000,21571189,21571189,12571189,12571189,54.7722557505,18.627869134,19.1838786164,74,0,0,
Down to You,3252,9000000,20035310,20035310,11035310,11035310,54.7722557505,18.6153059002,19.1766930041,0,0,0,
Harold & Kumar Go to White Castle,3253,9000000,18225165,18225165,9225165,9225165,54.7722557505,18.6002936942,19.1681574135,37,0,0,
The Contender,3254,9000000,17804273,17804273,8804273,8804273,54.7722557505,18.5967705487,19.1661622484,15,0,0,
Boiler Room,3255,9000000,16963963,28773637,7963963,19773637,54.7722557505,18.6847656735,19.1621669584,96,0,0,
Black Christmas,3256,9000000,16235738,16235738,7235738,7235738,54.7722557505,18.5835304488,19.1586916236,46,0,0,
The Ice Pirates,3257,9000000,13075390,13075390,4075390,4075390,54.7722557505,18.5563092163,19.1434678449,13,0,0,
Breakin' All the Rules,3258,9000000,12232382,12512317,3232382,3512317,54.7722557505,18.5513805227,19.1393675101,76,0,0,
Glee: The 3D Concert Movie,3259,9000000,11862398,17462398,2862398,8462398,54.7722557505,18.5938996639,19.1375626102,16,0,0,
Henry V,3260,9000000,10161099,10161099,1161099,1161099,54.7722557505,18.5305332247,19.1292209418,94,0,0,
The Savages,3261,9000000,6610326,10629267,-2389674,1629267,54.7722557505,18.5347190793,19.111583643,51,0,0,
Chasing Papi,3262,9000000,6126237,12657377,-2873763,3657377,54.7722557505,18.5526525874,19.1091548126,56,0,0,
The Way of the Gun,3263,9000000,6047856,13061935,-2952144,4061935,54.7722557505,18.5561917247,19.1087609943,51,0,0,
Hamlet 2,3264,9000000,4886216,4934104,-4113784,-4065896,54.7722557505,18.4825690001,19.1029061839,88,0,0,
Igby Goes Down,3265,9000000,4777465,4777465,-4222535,-4222535,54.7722557505,18.4810955274,19.1023563064,44,0,0,
PCU,3266,9000000,4333569,4333569,-4666431,-4666431,54.7722557505,18.4769080507,19.1001086948,85,0,0,
The Ultimate Gift,3267,9000000,3438735,3438735,-5561265,-5561265,54.7722557505,18.4684129869,19.0955624009,84,0,0,
Beautiful,3268,9000000,3134509,3134509,-5865491,-5865491,54.7722557505,18.4655083151,19.0940120302,7,0,0,
Gracie,3269,9000000,2956339,3922043,-6043661,-5077957,54.7722557505,18.4730102089,19.093102938,73,0,0,
Trust the Man,3270,9000000,1530535,2548378,-7469465,-6451622,54.7722557505,18.4598881879,19.0857980114,69,0,0,
Undiscovered,3271,9000000,1069318,1069318,-7930682,-7930682,54.7722557505,18.4455641677,19.0834235558,12,0,0,
Velvet Goldmine,3272,9000000,1043487,4303343,-7956513,-4696657,54.7722557505,18.4766222761,19.0832904047,58,0,0,
Princess Kaiulani,3273,9000000,883887,883887,-8116113,-8116113,54.7722557505,18.4437537922,19.0824673213,49,0,0,
The Legend of Suriyothai,3274,9000000,454255,454255,-8545745,-8545745,54.7722557505,18.4395466288,19.0802482659,36,0,0,
Due occhi diabolici,3275,9000000,349618,349618,-8650382,-8650382,54.7722557505,18.4385192869,19.0797070678,29,0,0,
La fille du RER,3276,9000000,208163,208163,-8791837,-8791837,54.7722557505,18.4371287804,19.0789749756,29,0,0,
All or Nothing,3277,9000000,184255,184255,-8815745,-8815745,54.7722557505,18.436893573,19.0788511882,52,0,0,
The Red Riding Trilogy: 1974,3278,9000000,148826,148826,-8851174,-8851174,54.7722557505,18.4365449199,19.0786677208,70,0,0,
Flammen og Citronen,3279,9000000,148089,1635241,-8851911,-7364759,54.7722557505,18.4510691341,19.0786639039,26,0,0,
Leaves of Grass,3280,9000000,70066,70066,-8929934,-8929934,54.7722557505,18.4357694153,19.0782597452,4,0,0,
Opal Dreams,3281,9000000,14443,14443,-8985557,-8985557,54.7722557505,18.435221365,19.0779715186,67,0,0,
Skin Trade,3282,9000000,1242,1242,-8998758,-8998758,54.7722557505,18.4350912521,19.0779031016,26,0,0,
Polisse,3287,8900000,176988,22744132,-8723012,13844132,54.619472517,18.6381632941,19.0793312424,17,0,0,
Crocodile Dundee,3289,8800000,168134511,321534511,159334511,312734511,54.4653963066,19.86331941,19.7051523021,70,0,0,
Awake,3291,8600000,14373825,32968648,5773825,24368648,54.1532608411,18.7194428802,19.1516782087,5,0,0,
Crazy Heart,3292,8500000,39464306,47409815,30964306,38909815,53.9951474433,18.8218704389,19.2661438952,47,0,0,
Star Wars: The Clone Wars,3293,8500000,35161554,68695443,26661554,60195443,53.9951474433,18.9550999474,19.2474968858,84,0,0,
The DUFF,3294,8500000,34030343,43528634,25530343,35028634,53.9951474433,18.795541452,19.2425362348,59,0,0,
Nightcrawler,3295,8500000,32381218,50334418,23881218,41834418,53.9951474433,18.8412620906,19.2352600232,76,0,0,
The Lost Boys,3296,8500000,30331685,30331685,21831685,21831685,53.9951474433,18.7004460136,19.22614273,76,0,0,
The Rose,3297,8500000,29200000,29200000,20700000,20700000,53.9951474433,18.6918541096,19.2210726086,65,0,0,
Baggage Claim,3298,8500000,21569509,22885836,13069509,14385836,53.9951474433,18.6425120587,19.186198957,31,0,0,
Haakon Haakonsen,3299,8500000,15024232,15024232,6524232,6524232,53.9951474433,18.5774662981,19.1552843722,43,0,0,
Election,3300,8500000,14879556,17138828,6379556,8638828,53.9951474433,18.5953822586,19.1545901269,42,0,0,
The Namesake,3301,8500000,13569248,20247501,5069248,11747501,53.9951474433,18.6211511349,19.1482804079,59,0,0,
All is Lost,3302,8500000,6263670,10292010,-2236330,1792010,53.9951474433,18.5361700578,19.1123517906,83,0,0,
Club Dread,3303,8500000,5001655,7573551,-3498345,-926449,53.9951474433,18.5116523714,19.1060123423,60,0,0,
Bright Star,3304,8500000,4444637,17220091,-4055363,8720091,53.9951474433,18.5960643975,19.1032014531,61,0,0,
Glitter,3305,8500000,4273372,4273372,-4226628,-4226628,53.9951474433,18.4810569962,19.1023356051,8,0,0,
Silmido,3306,8500000,298347,30298347,-8201653,21798347,53.9951474433,18.7001939595,19.0820258984,59,0,0,
My Name is Khan,3307,8470000,4018771,42327961,-4451229,33857961,53.9474414794,18.787461869,19.101198974,0,0,0,
Namastey London,3308,8400000,1207007,6831069,-7192993,-1568931,53.8356327096,18.5057689571,19.0872186574,29,0,0,
Yeh Jawaani Hai Deewani,3309,8300000,3827466,50827466,-4472534,42527466,53.6746873133,18.8458027695,19.1010910894,76,0,0,
Limbo,3310,8300000,1997807,2435321,-6302193,-5864679,53.6746873133,18.4655160791,19.0917823365,45,0,0,
The Wind That Shakes the Barley,3311,8300000,1829142,25670174,-6470858,17370174,53.6746873133,18.6661368368,19.0909198416,5,0,0,
The City of Your Final Destination,3312,8300000,493296,1353296,-7806704,-6946704,53.6746873133,18.4551163538,19.0840623785,81,0,0,
Quo Vadis?,3314,8250000,30000000,30000000,21750000,21750000,53.5936686864,18.699828316,19.2257776283,77,0,0,
The Sound of Music,3315,8200000,163214286,286214286,155014286,278014286,53.5122809517,19.7777124186,19.6931219819,52,0,0,
Footloose,3316,8200000,75846770,75846770,67646770,67646770,53.5122809517,18.9978389711,19.4124057632,61,0,0,
Pulp Fiction,3317,8000000,107886108,212886108,99886108,204886108,53.1829589694,19.5691504049,19.5253659849,27,0,0,
The Karate Kid,3318,8000000,90815558,90815558,82815558,82815558,53.1829589694,19.0795770015,19.4671463181,16,0,0,
The Muppet Movie,3319,8000000,76657000,76657000,68657000,68657000,53.1829589694,19.0034953018,19.416146069,77,0,0,
Splash,3320,8000000,62599495,62599495,54599495,54599495,53.1829589694,18.9217574229,19.3627983367,45,0,0,
Little Miss Sunshine,3321,8000000,59891098,100642353,51891098,92642353,53.1829589694,19.1291725661,19.3521848396,74,0,0,
Easy A,3322,8000000,58401464,76200721,50401464,68200721,53.1829589694,19.0009445329,19.3462989791,82,0,0,
Stand by Me,3323,8000000,52287414,52287414,44287414,44287414,53.1829589694,18.857241699,19.321771479,42,0,0,
28 Days Later...,3324,8000000,45064915,82955633,37064915,74955633,53.1829589694,19.0380578989,19.2920002016,47,0,0,
Escape from Alcatraz,3325,8000000,43000000,43000000,35000000,35000000,53.1829589694,18.7953446068,19.2833230778,14,0,0,
You Got Served,3326,8000000,40066497,50811858,32066497,42811858,53.1829589694,18.8476600857,19.2708650831,12,0,0,
50/50,3327,8000000,35014192,41332809,27014192,33332809,53.1829589694,18.7838161313,19.2490382763,77,0,0,
A Thin Line Between Love & Hate,3328,8000000,34873513,34873513,26873513,26873513,53.1829589694,18.7378518711,19.2484236493,49,0,0,
Brown Sugar,3329,8000000,27362712,28315272,19362712,20315272,53.1829589694,18.6889163079,19.215048029,80,0,0,
That Awkward Moment,3330,8000000,26068955,53068955,18068955,45068955,53.1829589694,18.8622797354,19.2091848124,26,0,0,
Shutter,3331,8000000,25928550,47782426,17928550,39782426,53.1829589694,18.8276957704,19.2085464339,21,0,0,
Howards End,3332,8000000,25919211,25919211,17919211,17919211,53.1829589694,18.670423016,19.2085039579,3,0,0,
Modern Problems,3333,8000000,22886688,22886688,14886688,14886688,53.1829589694,18.6465161092,19.194615012,61,0,0,
On Her Majesty's Secret Service,3334,8000000,22800000,82000000,14800000,74000000,53.1829589694,19.0328902941,19.1942151313,74,0,0,
Much Ado About Nothing,3335,8000000,22549338,22549338,14549338,14549338,53.1829589694,18.6438209353,19.193057959,78,0,0,
The Player,3336,8000000,21706101,28876702,13706101,20876702,53.1829589694,18.6932005277,19.1891553265,65,0,0,
Creepshow,3337,8000000,20036244,20036244,12036244,12036244,53.1829589694,18.6235112636,19.1813817311,54,0,0,
Akeelah and the Bee,3338,8000000,18848430,18959424,10848430,10959424,53.1829589694,18.6146810546,19.1758151517,85,0,0,
Wes Craven's New Nightmare,3339,8000000,17976855,17976855,9976855,9976855,53.1829589694,18.6065551237,19.1717107959,42,0,0,
Drive Me Crazy,3340,8000000,17843379,22591451,9843379,14591451,53.1829589694,18.6441577837,19.1710807506,83,0,0,
Enough Said,3341,8000000,17550872,22850872,9550872,14850872,53.1829589694,18.6462303106,19.1696986433,89,0,0,
Half Baked,3342,8000000,17278980,17278980,9278980,9278980,53.1829589694,18.6007432678,19.1684122274,28,0,0,
New in Town,3343,8000000,16734283,29937909,8734283,21937909,53.1829589694,18.7012487036,19.1658300866,36,0,0,
Begin Again,3344,8000000,16170632,61584027,8170632,53584027,53.1829589694,18.9155859213,19.1631510562,64,0,0,
American Psycho,3345,8000000,15047419,28651551,7047419,20651551,53.1829589694,18.6914846253,19.1577909329,87,0,0,
See No Evil,3346,8000000,15032800,18828036,7032800,10828036,53.1829589694,18.6135982813,19.1577209793,80,0,0,
The Good Girl,3347,8000000,14018296,16585503,6018296,8585503,53.1829589694,18.5949343842,19.1528544698,66,0,0,
"Bon Cop, Bad Cop",3348,8000000,12628571,12697976,4628571,4697976,53.1829589694,18.5617307087,19.1461493732,48,0,0,
The Boondock Saints 2: All Saints Day,3349,8000000,10273187,10629320,2273187,2629320,53.1829589694,18.5436022175,19.1346815092,1,0,0,
Prom,3350,8000000,10130219,10763183,2130219,2763183,53.1829589694,18.5447853122,19.1339811767,13,0,0,
The Inkwell,3351,8000000,8864699,8864699,864699,864699,53.1829589694,18.5278740481,19.1277605137,52,0,0,
Shadow of the Vampire,3352,8000000,8279017,8279017,279017,279017,53.1829589694,18.5225986718,19.1248684431,97,0,0,
It's Kind of a Funny Story,3353,8000000,6363628,6632950,-1636372,-1367050,53.1829589694,18.5076213785,19.1153515083,34,0,0,
The Pallbearer,3354,8000000,5612586,5612586,-2387414,-2387414,53.1829589694,18.4982233568,19.1115949684,82,0,0,
Woman on Top,3355,8000000,5018450,10192613,-2981550,2192613,53.1829589694,18.5397327964,19.1086132065,95,0,0,
Held Up,3356,8000000,4714090,4714090,-3285910,-3285910,53.1829589694,18.4898740274,19.1070822788,98,0,0,
Caché,3357,8000000,3647381,19891331,-4352619,11891331,53.1829589694,18.6223274694,19.1016981656,60,0,0,
Another Year,3358,8000000,3205706,20005613,-4794294,12005613,53.1829589694,18.6232611557,19.0994603383,68,0,0,
8 femmes,3359,8000000,3076425,42376425,-4923575,34376425,53.1829589694,18.7910481854,19.0988043639,82,0,0,
Showdown in Little Tokyo,3360,8000000,2275557,2275557,-5724443,-5724443,53.1829589694,18.4668560544,19.0947311259,88,0,0,
Clay Pigeons,3361,8000000,1789892,2253139,-6210108,-5746861,53.1829589694,18.4666419677,19.0922529138,29,0,0,
Made in Dagenham,3362,8000000,1095369,15644196,-6904631,7644196,53.1829589694,18.5869951845,19.0886982527,29,0,0,
And When Did You Last See Your Father?,3363,8000000,1071240,2476491,-6928760,-5523509,53.1829589694,18.4687728837,19.0885745299,2,0,0,
The Secret of Kells,3364,8000000,690290,3582797,-7309710,-4417203,53.1829589694,18.4792612923,19.0866191555,75,0,0,
Prefontaine,3365,8000000,590817,590817,-7409183,-7409183,53.1829589694,18.4506380979,19.0861079414,58,0,0,
The Wicked Lady,3366,8000000,589308,589308,-7410692,-7410692,53.1829589694,18.4506234532,19.0861001843,92,0,0,
Down in the Valley,3367,8000000,568932,973443,-7431068,-7026557,53.1829589694,18.4543445558,19.0859954343,19,0,0,
Brooklyn Rules,3368,8000000,458232,458232,-7541768,-7541768,53.1829589694,18.4493505493,19.0854261507,7,0,0,
The Singing Detective,3369,8000000,336456,524747,-7663544,-7475253,53.1829589694,18.4499966916,19.0847995332,56,0,0,
Fido,3370,8000000,298110,456814,-7701890,-7543186,53.1829589694,18.44933677,19.0846021365,88,0,0,
Restless,3371,8000000,163141,2817782,-7836859,-5182218,53.1829589694,18.4720202654,19.0839070361,93,0,0,
The Land Girls,3372,8000000,146083,146083,-7853917,-7853917,53.1829589694,18.4463126714,19.0838191517,15,0,0,
The Wendell Baker Story,3373,8000000,127188,127188,-7872812,-7872812,53.1829589694,18.4461284861,19.0837217939,91,0,0,
Wild Target,3374,8000000,109338,109338,-7890662,-7890662,53.1829589694,18.4459544561,19.0836298119,33,0,0,
Pathology,3375,8000000,109045,3270974,-7890955,-4729026,53.1829589694,18.4763161498,19.0836283019,13,0,0,
10th & Wolf,3376,8000000,54702,143782,-7945298,-7856218,53.1829589694,18.4462902435,19.0833482169,10,0,0,
Aloft,3377,8000000,53086,53086,-7946914,-7946914,53.1829589694,18.4454058244,19.0833398868,100,0,0,
Dear Wendy,3378,8000000,23106,446438,-7976894,-7553562,53.1829589694,18.449235936,19.0831853343,47,0,0,
Akira,3379,8000000,19585,19585,-7980415,-7980415,53.1829589694,18.4450789426,19.0831671813,59,0,0,
Imagine Me & You,3390,7900000,672243,3129471,-7227757,-4770529,53.0159774456,18.4759235025,19.0870401341,58,0,0,
Swimming Pool,3391,7800000,10105505,23996679,2305505,16196679,52.8474030464,18.6569136231,19.1348397519,54,0,0,
The Blood of Heroes,3392,7700000,882290,882290,-6817710,-6817710,52.6771998601,18.456361854,19.0891438183,0,0,0,
Loin des hommes,3393,7700000,5336,745093,-7694664,-6954907,52.6771998601,18.4550370973,19.0846393373,8,0,0,
Driving Miss Daisy,3394,7500000,102647257,102647257,95147257,95147257,52.3317569696,19.1414309271,19.5095408948,61,0,0,
Soul Food,3395,7500000,43490057,43490057,35990057,35990057,52.3317569696,18.8021283881,19.2874928624,74,0,0,
(500) Days of Summer,3396,7500000,32391374,59101642,24891374,51601642,52.3317569696,18.9034271136,19.2397232773,19,0,0,
Rumble in the Bronx,3397,7500000,32281907,36238752,24781907,28738752,52.3317569696,18.7513432367,19.2392405717,19,0,0,
Thank You For Smoking,3398,7500000,24793509,40016662,17293509,32516662,52.3317569696,18.7781237209,19.2056539964,43,0,0,
Hostel: Part II,3399,7500000,17544812,33606409,10044812,26106409,52.3317569696,18.7322501122,19.1720314202,9,0,0,
An Education,3400,7500000,12574914,29652736,5074914,22152736,52.3317569696,18.7028700941,19.1483077782,15,0,0,
Extract,3401,7500000,10823158,10849158,3323158,3349158,52.3317569696,18.5499478073,19.1398098471,77,0,0,
Narc,3402,7500000,10465659,11843260,2965659,4343260,52.3317569696,18.5586454375,19.1380666781,85,0,0,
Shopgirl,3403,7500000,10284523,11758418,2784523,4258418,52.3317569696,18.5579060806,19.1371822958,56,0,0,
The Hotel New Hampshire,3404,7500000,5068118,5068118,-2431882,-2431882,52.3317569696,18.4978117707,19.1113721065,86,0,0,
Men with Brooms,3405,7500000,4239767,4239767,-3260233,-3260233,52.3317569696,18.4901136027,19.1072115244,16,0,0,
Witless Protection,3406,7500000,4151836,4151836,-3348164,-3348164,52.3317569696,18.4892929378,19.1067688528,76,0,0,
The Work and the Glory,3407,7500000,3347439,3347439,-4152561,-4152561,52.3317569696,18.4817540276,19.1027101505,92,0,0,
Albert Nobbs,3408,7500000,3014696,8539003,-4485304,1039003,52.3317569696,18.5294386869,19.1010264188,39,0,0,
Masked and Anonymous,3409,7500000,533344,555335,-6966656,-6944665,52.3317569696,18.4551360534,19.0883801851,13,0,0,
Betty Fisher et autres histoires,3410,7500000,206400,206400,-7293600,-7293600,52.3317569696,18.4517591872,19.0867019238,57,0,0,
Code 46,3411,7500000,197148,1788324,-7302852,-5711676,52.3317569696,18.4669779558,19.0866543907,18,0,0,
Ta Ra Rum Pum,3417,7400000,872643,9443864,-6527357,2043864,52.1564387372,18.5384113872,19.0906307587,10,0,0,
Crash,3418,7303082,55334418,101173038,48031336,93869956,51.9848199643,19.1351989194,19.3368620979,88,0,0,
Persepolis,3419,7300000,4443403,25397460,-2856597,18097460,51.9793345208,18.6718106153,19.1092410409,57,0,0,
Harry Brown,3420,7300000,1818681,12023606,-5481319,4723606,51.9793345208,18.5619532667,19.0959694164,71,0,0,
Diamonds Are Forever,3422,7200000,43800000,116000000,36600000,108800000,51.8004012822,19.205724293,19.290053107,96,0,0,
The Omega Code,3423,7200000,12610552,12678312,5410552,5478312,51.8004012822,18.5684846456,19.1499277777,24,0,0,
3,3424,7200000,59774,59774,-7140226,-7140226,51.8004012822,18.4532448898,19.0874895704,46,0,0,
Juno,3425,7000000,143495265,231450102,136495265,224450102,51.4368672361,19.629343565,19.6398472945,52,0,0,
The Godfather,3426,7000000,134821952,268355541,127821952,261355541,51.4368672361,19.7338821872,19.6138856005,0,0,0,
Magic Mike,3427,7000000,113721571,170549753,106721571,163549753,51.4368672361,19.4286386461,19.547760275,43,0,0,
Flashdance,3428,7000000,90463574,201463574,83463574,194463574,51.4368672361,19.5355397242,19.4694194143,94,0,0,
The Piano,3429,7000000,38513715,38513715,31513715,31513715,51.4368672361,18.7710837595,19.2685000513,65,0,0,
Jumping the Broom,3430,7000000,37295394,38158601,30295394,31158601,51.4368672361,18.7685791879,19.2632677328,36,0,0,
Live and Let Die,3431,7000000,35400000,161800000,28400000,154800000,51.4368672361,19.3961842478,19.2550727712,66,0,0,
My Dog Skip,3432,7000000,34099640,35795319,27099640,28795319,51.4368672361,18.7517495584,19.2494114146,29,0,0,
Darkness Falls,3433,7000000,32539681,47289758,25539681,40289758,51.4368672361,18.8310670564,19.2425772852,61,0,0,
"Definitely, Maybe",3434,7000000,31973840,55350057,24973840,48350057,51.4368672361,18.8831579897,19.2400867655,54,0,0,
"Good Night, and Good Luck",3435,7000000,31501218,56586901,24501218,49586901,51.4368672361,18.8909164901,19.2380017798,92,0,0,
Capote,3436,7000000,28750530,49924079,21750530,42924079,51.4368672361,18.848392034,19.2257799976,78,0,0,
The Great Gatsby,3437,7000000,26533200,26533200,19533200,19533200,51.4368672361,18.6829176312,19.2158181115,49,0,0,
The Descent,3438,7000000,26024456,57051053,19024456,50051053,51.4368672361,18.8938125691,19.2135183923,36,0,0,
Desperado,3439,7000000,25405445,25405445,18405445,18405445,51.4368672361,18.6742036308,19.2107130725,4,0,0,
Logan's Run,3440,7000000,25000000,25000000,18000000,18000000,51.4368672361,18.6710521656,19.2088713461,29,0,0,
Fargo,3441,7000000,24547547,51184363,17547547,44184363,51.4368672361,18.8565755048,19.206812074,11,0,0,
Kingdom Come,3442,7000000,23247539,23393939,16247539,16393939,51.4368672361,18.65846997,19.200871576,98,0,0,
The Man with the Golden Gun,3443,7000000,21000000,97600000,14000000,90600000,51.4368672361,19.119065395,19.1905172668,69,0,0,
Action Jackson,3444,7000000,20257000,20257000,13257000,13257000,51.4368672361,18.6334283806,19.1870705842,98,0,0,
Michael Jordan to the MAX,3445,7000000,18642318,18642318,11642318,11642318,51.4368672361,18.6202900036,19.1795390657,70,0,0,
Dope,3446,7000000,17506470,18115484,10506470,11115484,51.4368672361,18.6159656293,19.1742068268,79,0,0,
The Devil's Rejects,3447,7000000,17044981,20940428,10044981,13940428,51.4368672361,18.6389377355,19.1720322174,51,0,0,
Devil's Due,3448,7000000,15821461,36146087,8821461,29146087,51.4368672361,18.7542654515,19.1662438031,76,0,0,
Flirting with Disaster,3449,7000000,14702438,15998144,7702438,8998144,51.4368672361,18.5983949198,19.1609202625,19,0,0,
Beyond the Lights,3450,7000000,14618727,14618727,7618727,7618727,51.4368672361,18.5867794948,19.1605208816,67,0,0,
In Too Deep,3451,7000000,14003141,15447861,7003141,8447861,51.4368672361,18.593777407,19.1575790426,88,0,0,
Buffy the Vampire Slayer,3452,7000000,13662164,13662164,6662164,6662164,51.4368672361,18.5786447667,19.1559458071,7,0,0,
"House of 1,000 Corpses",3453,7000000,12583510,16954014,5583510,9954014,51.4368672361,18.6063654391,19.150761558,13,0,0,
Silver Bullet,3454,7000000,10803211,10803211,3803211,3803211,51.4368672361,18.5539298106,19.1421458213,33,0,0,
The House of the Dead,3455,7000000,10199354,13767816,3199354,6767816,51.4368672361,18.5795465018,19.1392065213,78,0,0,
A Serious Man,3456,7000000,9228788,30360570,2228788,23360570,51.4368672361,18.7119375096,19.134464072,0,0,0,
Get Low,3457,7000000,9176933,9696933,2176933,2696933,51.4368672361,18.544199963,19.1342100604,23,0,0,
A Single Man,3458,7000000,9176000,28142379,2176000,21142379,51.4368672361,18.6952215039,19.1342054895,65,0,0,
Warlock,3459,7000000,8824553,8824553,1824553,1824553,51.4368672361,18.5364599512,19.1324822163,4,0,0,
The Last Temptation of Christ,3460,7000000,8373585,8373585,1373585,1373585,51.4368672361,18.5324352177,19.1302665962,17,0,0,
Cyrus,3461,7000000,7461082,10055042,461082,3055042,51.4368672361,18.547359949,19.1257683679,36,0,0,
Outside Providence,3462,7000000,7309628,7824358,309628,824358,51.4368672361,18.5275115783,19.1250198062,18,0,0,
Bride & Prejudice,3463,7000000,6601079,25269040,-398921,18269040,51.4368672361,18.6731444827,19.1215103391,74,0,0,
Rabbit-Proof Fence,3464,7000000,6199600,16866928,-800400,9866928,51.4368672361,18.6056418974,19.1195163199,96,0,0,
Who's Your Caddy?,3465,7000000,5694308,5694308,-1305692,-1305692,51.4368672361,18.5081837085,19.1170010299,47,0,0,
Split Second,3466,7000000,5430822,5430822,-1569178,-1569178,51.4368672361,18.5057666886,19.1156869106,8,0,0,
Nikita,3467,7000000,5017971,5017971,-1982029,-1982029,51.4368672361,18.5019677204,19.1136243638,6,0,0,
The Other Side of Heaven,3468,7000000,4720371,4720371,-2279629,-2279629,51.4368672361,18.4992202887,19.1121349523,95,0,0,
Dark Angel,3469,7000000,4372561,4372561,-2627439,-2627439,51.4368672361,18.4959997248,19.1103914366,44,0,0,
Veer-Zaara,3470,7000000,2938532,7017859,-4061468,17859,51.4368672361,18.5202373586,19.1031706015,100,0,0,
Redbelt,3471,7000000,2344847,2667084,-4655153,-4332916,51.4368672361,18.4800558891,19.1001658621,4,0,0,
A Dog of Flanders,3472,7000000,2165637,2165637,-4834363,-4834363,51.4368672361,18.4753192873,19.0992570734,28,0,0,
Auto Focus,3473,7000000,2062066,2703821,-4937934,-4296179,51.4368672361,18.4804020215,19.0987314795,36,0,0,
The Mighty Macs,3474,7000000,1891936,1891936,-5108064,-5108064,51.4368672361,18.4727244478,19.0978675172,94,0,0,
Somewhere,3475,7000000,1785645,17023121,-5214355,10023121,51.4368672361,18.6069392326,19.097327366,93,0,0,
We Need to Talk About Kevin,3476,7000000,1738692,10765283,-5261308,3765283,51.4368672361,18.5535977917,19.0970886667,11,0,0,
Factory Girl,3477,7000000,1661464,1661464,-5338536,-5338536,51.4368672361,18.4705342094,19.0966959314,47,0,0,
The Christmas Candle,3478,7000000,1632000,1632000,-5368000,-5368000,51.4368672361,18.4702538588,19.0965460546,92,0,0,
I Hope They Serve Beer in Hell,3479,7000000,1429299,1429453,-5570701,-5570547,51.4368672361,18.4683244894,19.0955143501,56,0,0,
Losin' It,3480,7000000,1246141,1246141,-5753859,-5753859,51.4368672361,18.466575129,19.0945811989,5,0,0,
Mother and Child,3481,7000000,1110509,5010509,-5889491,-1989491,51.4368672361,18.5018989237,19.0938896211,64,0,0,
March or Die,3482,7000000,1000000,1000000,-6000000,-6000000,51.4368672361,18.464221363,19.0933257898,9,0,0,
Les Visiteurs,3483,7000000,659000,98754000,-6341000,91754000,51.4368672361,19.1247888436,19.0915839567,48,0,0,
The Extra Man,3484,7000000,453377,457877,-6546623,-6542123,51.4368672361,18.4590175956,19.0905321632,88,0,0,
Hesher,3485,7000000,382946,382946,-6617054,-6617054,51.4368672361,18.4582962079,19.0901716432,40,0,0,
Chairman of the Board,3486,7000000,306715,306715,-6693285,-6693285,51.4368672361,18.4575617703,19.0897812878,70,0,0,
Gerry,3487,7000000,254683,719699,-6745317,-6280301,51.4368672361,18.4615341717,19.0895147605,71,0,0,
Wah-Wah,3488,7000000,234750,463039,-6765250,-6536961,51.4368672361,18.4590672728,19.0894126374,7,0,0,
The Heart of Me,3489,7000000,196067,196067,-6803933,-6803933,51.4368672361,18.4564947861,19.0892144223,96,0,0,
Ca$h,3490,7000000,46488,46488,-6953512,-6953512,51.4368672361,18.4550505761,19.0884475967,37,0,0,
Trudno byt bogom,3491,7000000,31443,35919,-6968557,-6964081,51.4368672361,18.4549484517,19.088370435,16,0,0,
The Boondock Saints,3492,7000000,30471,411874,-6969529,-6588126,51.4368672361,18.4585747698,19.0883654497,89,0,0,
Pale Rider,3501,6900000,41410568,41410568,34510568,34510568,51.2521717326,18.7919739881,19.2812553161,99,0,0,
House at the End of the Street,3502,6900000,31611916,44103982,24711916,37203982,51.2521717326,18.810383774,19.2389318172,47,0,0,
Dazed and Confused,3503,6900000,7950889,7950889,1050889,1050889,51.2521717326,18.5295452924,19.1286781619,74,0,0,
Incendies,3505,6800000,6857096,16038343,57096,9238343,51.0654576214,18.6004038027,19.1237704188,21,0,0,
Aimée & Jaguar,3506,6800000,927107,927107,-5872893,-5872893,51.0654576214,18.4654375375,19.0939742788,3,0,0,
The Chumscrubber,3507,6800000,49526,49526,-6750474,-6750474,51.0654576214,18.4570104361,19.0894883405,36,0,0,
Shade,3508,6800000,25032,9533964,-6774968,2733964,51.0654576214,18.5445271911,19.0893628452,84,0,0,
Bran Nue Dae,3509,6750000,113568,6812530,-6636432,62530,50.9713273454,18.520641656,19.0900724289,16,0,0,
"Remember Me, My Love",3510,6700000,223878,223878,-6476122,-6476122,50.8766726615,18.4596525801,19.0908929114,75,0,0,
Perrier's Bounty,3511,6600000,828,828,-6599172,-6599172,50.6857624559,18.4584684117,19.0902631893,13,0,0,
Tropa de Elite,3512,6537890,8744,14319195,-6529146,7781305,50.5660933787,18.5881555225,19.0906216038,84,0,0,
Annabelle,3513,6500000,84273813,250673813,77773813,244173813,50.4926703274,19.6865687863,19.4492822647,39,0,0,
Hannah Montana/Miley Cyrus: Best of Both Worlds Concert Tour,3514,6500000,65281781,70712099,58781781,64212099,50.4926703274,18.9783651881,19.3789694903,90,0,0,
Boyz n the Hood,3515,6500000,56190094,56190094,49690094,49690094,50.4926703274,18.8915610888,19.3434759359,2,0,0,
La Bamba,3516,6500000,52678820,52678820,46178820,46178820,50.4926703274,18.8693909055,19.3294236264,60,0,0,
The Four Seasons,3517,6500000,42488161,42488161,35988161,35988161,50.4926703274,18.8021154407,19.2874848937,99,0,0,
Dressed to Kill,3518,6500000,31899000,31899000,25399000,25399000,50.4926703274,18.7270563142,19.2419586642,34,0,0,
The Adventures of Huck Finn,3519,6500000,24103594,24103594,17603594,17603594,50.4926703274,18.6679613273,19.2070673937,65,0,0,
Go!,3520,6500000,16842303,28350471,10342303,21850471,50.4926703274,18.7005880184,19.1734337876,22,0,0,
Friends with Money,3521,6500000,13368437,18110152,6868437,11610152,50.4926703274,18.6200265131,19.1569341466,25,0,0,
The Andromeda Strain,3522,6500000,12376563,12376563,5876563,5876563,50.4926703274,18.5719140725,19.1521726965,38,0,0,
Bats,3523,6500000,10155691,10155691,3655691,3655691,50.4926703274,18.5526378118,19.1414285584,81,0,0,
Nowhere in Africa,3524,6500000,6173485,6173485,-326515,-326515,50.4926703274,18.5171150827,19.121869534,66,0,0,
Shame,3525,6500000,4002293,20412841,-2497707,13912841,50.4926703274,18.6387159339,19.1110421178,55,0,0,
Layer Cake,3526,6500000,2338695,11744669,-4161305,5244669,50.4926703274,18.5664672068,19.1026659408,28,0,0,
The Work and the Glory: American Zion,3527,6500000,2024854,2024854,-4475146,-4475146,50.4926703274,18.4787146812,19.1010778619,63,0,0,
The Messenger,3528,6500000,1109660,1744952,-5390340,-4755048,50.4926703274,18.4760699816,19.096432401,50,0,0,
A Home at the End of the World,3529,6500000,1029017,1033810,-5470983,-5466190,50.4926703274,18.469319011,19.0960220263,25,0,0,
Aberdeen,3530,6500000,64148,64148,-6435852,-6435852,50.4926703274,18.460039813,19.0910989115,17,0,0,
The Terminator,3532,6400000,36953296,76953296,30553296,70553296,50.2973371873,19.0140271361,19.2643776301,86,0,0,
"Goodbye, Lenin!",3533,6400000,4063859,79384539,-2336141,72984539,50.2973371873,19.0273697454,19.1118518735,92,0,0,
Control,3534,6400000,871577,8902141,-5528423,2502141,50.2973371873,18.5424768986,19.0957296239,62,0,0,
The Damned United,3535,6400000,449865,4199874,-5950135,-2200126,50.2973371873,18.4999549965,19.0935802468,53,0,0,
Die Fälscher,3536,6250000,5484715,20195808,-765285,13945808,50.0,18.6389809854,19.1196908838,44,0,0,
Return of the Living Dead Part II,3537,6200000,9205924,9205924,3005924,3005924,49.8996985923,18.5469271177,19.1382631626,97,0,0,
Gomorra,3538,6200000,1579146,37339594,-4620854,31139594,49.8996985923,18.7684449571,19.1003397011,59,0,0,
Mallrats,3539,6100000,2028211,2028211,-4071789,-4071789,49.6972615649,18.4825136051,19.1031184422,62,0,0,
Grease,3540,6000000,181813770,387513770,175813770,381513770,49.4923200384,20.0139161255,19.7497566362,43,0,0,
Platoon,3541,6000000,132761962,132761962,126761962,126761962,49.4923200384,19.2844656741,19.6106660264,68,0,0,
Fahrenheit 9/11,3542,6000000,119114517,221148959,113114517,215148959,49.4923200384,19.6011777382,19.5682604446,57,0,0,
Butch Cassidy and the Sundance Kid,3543,6000000,102308900,102308900,96308900,96308900,49.4923200384,19.1470651086,19.51344336,99,0,0,
Mary Poppins,3544,6000000,102300000,102300000,96300000,96300000,49.4923200384,19.1470220624,19.5134135188,91,0,0,
Ordinary People,3545,6000000,52302978,52302978,46302978,46302978,49.4923200384,18.8701832796,19.3299238959,21,0,0,
West Side Story,3546,6000000,43700000,43700000,37700000,37700000,49.4923200384,18.8137374655,19.2946538676,41,0,0,
Around the World in 80 Days,3547,6000000,42000000,42000000,36000000,36000000,49.4923200384,18.8021962837,19.2875346509,19,0,0,
Caddyshack,3548,6000000,39846344,39846344,33846344,33846344,49.4923200384,18.7873813645,19.2784422335,69,0,0,
The Brothers,3549,6000000,27457409,27958191,21457409,21958191,49.4923200384,18.7014018929,19.2244687598,31,0,0,
The Wrestler,3550,6000000,26238243,46634275,20238243,40634275,49.4923200384,18.8333499535,19.2189964598,87,0,0,
Escape from New York,3551,6000000,25244700,25244700,19244700,19244700,49.4923200384,18.6806956509,19.2145146295,97,0,0,
The Wood,3552,6000000,25059640,25059640,19059640,19059640,49.4923200384,18.6792677452,19.2136776079,95,0,0,
Do the Right Thing,3553,6000000,24289231,24289231,18289231,18289231,49.4923200384,18.6733013311,19.2101855193,47,0,0,
The Usual Suspects,3554,6000000,23272306,34380094,17272306,28380094,49.4923200384,18.7487631413,19.2055572781,22,0,0,
A Nightmare On Elm Street: The Dream Child,3555,6000000,22168359,22168359,16168359,16168359,49.4923200384,18.6566899843,19.2005086135,84,0,0,
National Lampoon's Van Wilder,3556,6000000,21005329,38941393,15005329,32941393,49.4923200384,18.7810901512,19.1951620288,33,0,0,
Duel in the Sun,3557,6000000,20400000,20400000,14400000,14400000,49.4923200384,18.6426255131,19.1923679083,8,0,0,
Best in Show,3558,6000000,18621249,20695413,12621249,14695413,49.4923200384,18.644988857,19.1841119555,44,0,0,
The Last King of Scotland,3559,6000000,17606684,49155371,11606684,43155371,49.4923200384,18.849898921,19.1793722132,78,0,0,
A Mighty Wind,3560,6000000,17583468,18504539,11583468,12504539,49.4923200384,18.6273272117,19.1792634917,85,0,0,
School Daze,3561,6000000,14545844,14545844,8545844,8545844,49.4923200384,18.5946011599,19.1649352354,4,0,0,
Daddy Day Camp,3562,6000000,13235267,18209872,7235267,12209872,49.4923200384,18.6249277876,19.1586893719,39,0,0,
Mr. Nice Guy,3563,6000000,12674183,31674183,6674183,25674183,49.4923200384,18.7290799152,19.1560034219,96,0,0,
War and Peace,3564,6000000,12500000,12500000,6500000,6500000,49.4923200384,18.5772591203,19.1551681256,90,0,0,
Mystic Pizza,3565,6000000,12465564,12465564,6465564,6465564,49.4923200384,18.576964627,19.1550029048,89,0,0,
Sliding Doors,3566,6000000,11883495,58781444,5883495,52781444,49.4923200384,18.9106811361,19.1522060521,64,0,0,
Tales from the Hood,3567,6000000,11784569,11784569,5784569,5784569,49.4923200384,18.5711229359,19.1517299321,95,0,0,
Halloween 5: The Revenge of Michael Myers,3568,6000000,11642254,11642254,5642254,5642254,49.4923200384,18.5698978107,19.1510445877,64,0,0,
The Words,3569,6000000,11494838,16369708,5494838,10369708,49.4923200384,18.6098119789,19.1503341829,80,0,0,
Bernie,3570,6000000,9204489,10106975,3204489,4106975,49.4923200384,18.556584968,19.1392315526,79,0,0,
Pollock,3571,6000000,8596914,10557291,2596914,4557291,49.4923200384,18.5605081886,19.1362654842,50,0,0,
Dolphins and Whales Tribes of the Ocean 3D,3572,6000000,7714996,17252287,1714996,11252287,49.4923200384,18.6170903384,19.1319444105,69,0,0,
200 Cigarettes,3573,6000000,6851636,6851636,851636,851636,49.4923200384,18.5277566895,19.1276961003,19,0,0,
City Island,3574,6000000,6671036,8173239,671036,2173239,49.4923200384,18.5395607867,19.1268051401,17,0,0,
Casa de mi Padre,3575,6000000,5909483,8446952,-90517,2446952,49.4923200384,18.541988175,19.1230393885,47,0,0,
The Guard,3576,6000000,5359774,21197454,-640226,15197454,49.4923200384,18.6489924852,19.1203123303,100,0,0,
The Virgin Suicides,3577,6000000,4859475,10619770,-1140525,4619770,49.4923200384,18.5610513012,19.11782391,60,0,0,
College,3578,6000000,4694491,5629618,-1305509,-370382,49.4923200384,18.5167166604,19.117001942,53,0,0,
La science des rêves,3579,6000000,4670644,15137932,-1329356,9137932,49.4923200384,18.5995645151,19.1168830778,58,0,0,
Little Voice,3580,6000000,4595000,21787233,-1405000,15787233,49.4923200384,18.6536754134,19.1165059405,6,0,0,
Miss March,3581,6000000,4543320,4713059,-1456680,-1286941,49.4923200384,18.5083554935,19.1162481983,85,0,0,
Simply Irresistible,3582,6000000,4398989,4398989,-1601011,-1601011,49.4923200384,18.5054742809,19.1155280286,6,0,0,
Wish I Was Here,3583,6000000,3591299,3591299,-2408701,-2408701,49.4923200384,18.4980263501,19.1114882898,80,0,0,
Venus,3584,6000000,3347411,7818479,-2652589,1818479,49.4923200384,18.5364058503,19.1102652458,11,0,0,
Veronica Mars,3585,6000000,3322127,3485383,-2677873,-2514617,49.4923200384,18.4970455426,19.1101383665,61,0,0,
Only the Strong,3586,6000000,3273588,3273588,-2726412,-2726412,49.4923200384,18.4950813805,19.1098947447,24,0,0,
Hedwig and the Angry Inch,3587,6000000,3067312,3748479,-2932688,-2251521,49.4923200384,18.4994801037,19.1088587637,87,0,0,
Shattered Glass,3588,6000000,2207975,3456602,-3792025,-2543398,49.4923200384,18.4967788574,19.1045313248,66,0,0,
The Wackness,3589,6000000,2077046,3330012,-3922954,-2669988,49.4923200384,18.4956050272,19.103870347,41,0,0,
Novocaine,3590,6000000,2025238,2522928,-3974762,-3477072,49.4923200384,18.4880886134,19.1036086805,24,0,0,
Snow Flower and the Secret Fan,3591,6000000,1348205,11348205,-4651795,5348205,49.4923200384,18.567361712,19.100182883,46,0,0,
The Business of Strangers,3592,6000000,1028337,1288337,-4971663,-4711663,49.4923200384,18.4764803702,19.0985602546,60,0,0,
Beastmaster 2: Through the Portal of Time,3593,6000000,773490,773490,-5226510,-5226510,49.4923200384,18.4715994223,19.097265578,0,0,0,
The Wild Bunch,3594,6000000,509424,509424,-5490576,-5490576,49.4923200384,18.4690867011,19.0959222963,48,0,0,
The 5th Quarter,3595,6000000,408159,408159,-5591841,-5591841,49.4923200384,18.4681214362,19.0954066907,90,0,0,
The First Great Train Robbery,3596,6000000,391942,391942,-5608058,-5608058,49.4923200384,18.467966768,19.0953240948,43,0,0,
Morvern Callar,3597,6000000,267194,267194,-5732806,-5732806,49.4923200384,18.466776195,19.0946885038,53,0,0,
The Flower of Evil,3598,6000000,181798,181798,-5818202,-5818202,49.4923200384,18.4659603725,19.0942531782,66,0,0,
Akmareul Boatda,3599,6000000,129210,13168809,-5870790,7168809,49.4923200384,18.5829615787,19.0939850046,35,0,0,
Come Early Morning,3600,6000000,119452,119452,-5880548,-5880548,49.4923200384,18.4653643354,19.0939352355,85,0,0,
The Greatest,3601,6000000,115862,115862,-5884138,-5884138,49.4923200384,18.4653300036,19.0939169247,25,0,0,
Deadfall,3602,6000000,66351,205891,-5933649,-5794109,49.4923200384,18.4661906101,19.0936643593,69,0,0,
Julia,3603,6000000,65108,1365108,-5934892,-4634892,49.4923200384,18.477206152,19.0936580177,83,0,0,
Lucky Break,3604,6000000,54606,4316497,-5945394,-1683503,49.4923200384,18.504716138,19.0936044364,16,0,0,
"Surfer, Dude",3605,6000000,36497,36497,-5963503,-5963503,49.4923200384,18.4645707219,19.0935120374,99,0,0,
Song One,3606,6000000,32251,32251,-5967749,-5967749,49.4923200384,18.4645300843,19.0934903714,100,0,0,
Lake of Fire,3607,6000000,25317,26007,-5974683,-5973993,49.4923200384,18.4644703213,19.0934549885,7,0,0,
Don McKay,3608,6000000,13722,13722,-5986278,-5986278,49.4923200384,18.4643527279,19.0933958185,92,0,0,
Videodrome,3614,5952000,2120439,2120439,-3831561,-3831561,49.3930370509,18.4847692983,19.1043317786,59,0,0,
Emma,3615,5900000,22041742,37641742,16141742,31741742,49.2848004997,18.7726887025,19.2003865712,78,0,0,
L'auberge espagnole,3616,5900000,3895664,3895664,-2004336,-2004336,49.2848004997,18.5017620445,19.1135127999,16,0,0,
The Planet of the Apes,3617,5800000,33395426,33395426,27595426,27595426,49.0746259869,18.743095116,19.2515736923,82,0,0,
The Train,3618,5800000,6800000,6800000,1000000,1000000,49.0746259869,18.5290887893,19.1284274362,47,0,0,
Winter in Wartime,3619,5800000,542860,9662214,-5257140,3862214,49.0746259869,18.5544460993,19.0971098582,40,0,0,
Foolproof,3620,5800000,230312,421021,-5569688,-5378979,49.0746259869,18.4701493732,19.0955195087,36,0,0,
Trade of Innocents,3621,5800000,15091,15091,-5784909,-5784909,49.0746259869,18.4662785132,19.0944229194,62,0,0,
Tom yum goong,3622,5700000,12044087,43044087,6344087,37344087,48.8617158649,18.8113321964,19.154419851,22,0,0,
Stiff Upper Lips,3623,5700000,69582,69582,-5630418,-5630418,48.8617158649,18.4677534724,19.0952102003,61,0,0,
The Inbetweeners,3624,5700000,35955,86051320,-5664045,80351320,48.8617158649,19.0667445036,19.095038891,57,0,0,
Bend it Like Beckham,3625,5600000,32543449,74566042,26943449,68966042,48.645985582,19.0052192728,19.2487292471,76,0,0,
Crossover,3626,5600000,7009668,7009668,1409668,1409668,48.645985582,18.5327578429,19.1304440539,23,0,0,
Sunshine State,3627,5600000,3064356,3064356,-2535644,-2535644,48.645985582,18.4968507131,19.1108518855,9,0,0,
Standing Ovation,3628,5600000,531806,531806,-5068194,-5068194,48.645985582,18.4731028571,19.0980700539,3,0,0,
Khiladi 786,3629,5600000,385422,14683763,-5214578,9083763,48.645985582,18.5991114496,19.0973262325,86,0,0,
[Rec] 2,3630,5600000,27766,18527766,-5572234,12927766,48.645985582,18.6307634365,19.0955065434,7,0,0,
The Sting,3631,5500000,159616327,159616327,154116327,154116327,48.4273464058,19.3936034563,19.6906032083,34,0,0,
Chariots of Fire,3632,5500000,55222653,55222653,49722653,49722653,48.4273464058,18.8917643836,19.3436053192,79,0,0,
Diary of a Mad Black Woman,3633,5500000,50406346,50458356,44906346,44958356,48.4273464058,18.8615683226,19.3242819716,93,0,0,
Shine,3634,5500000,35811509,35811509,30311509,30311509,48.4273464058,18.76257931,19.2633371208,20,0,0,
Don Jon,3635,5500000,24477704,40993475,18977704,35493475,48.4273464058,18.7987316054,19.2133067897,9,0,0,
Ghost World,3636,5500000,6200756,8744515,700756,3244515,48.4273464058,18.5490278452,19.1269518134,16,0,0,
Iris,3637,5500000,5580479,15155021,80479,9655021,48.4273464058,18.603879108,19.1238861704,20,0,0,
Galaxina,3638,5500000,4865000,4865000,-635000,-635000,48.4273464058,18.5143098935,19.1203382911,50,0,0,
Les Choristes,3639,5500000,3629758,83529758,-1870242,78029758,48.4273464058,19.0545024585,19.1141832564,66,0,0,
Mambo Italiano,3640,5500000,3031801,6148823,-2468199,648823,48.4273464058,18.5259328388,19.1111900585,85,0,0,
Wonderland,3641,5500000,1060512,1060512,-4439488,-4439488,48.4273464058,18.4790510999,19.1012584233,58,0,0,
De battre mon coeur s'est arrêté,3642,5500000,1023424,8589831,-4476576,3089831,48.4273464058,18.5476663987,19.1010706201,5,0,0,
Haevnen,3643,5500000,1008098,15867314,-4491902,10367314,48.4273464058,18.6097921641,19.1009930032,96,0,0,
Le Havre,3644,5500000,611709,13480196,-4888291,7980196,48.4273464058,18.5898363252,19.0989834383,56,0,0,
Harvard Man,3645,5500000,56653,56653,-5443347,-5443347,48.4273464058,18.4695365727,19.0961626788,23,0,0,
Salvation Boulevard,3646,5500000,28468,28468,-5471532,-5471532,48.4273464058,18.4692681258,19.096019232,81,0,0,
R100,3647,5500000,24956,24956,-5475044,-5475044,48.4273464058,18.4692346708,19.0960013563,87,0,0,
Rang De Basanti,3650,5300000,2197694,29197694,-3102306,23897694,47.9809637944,18.7159435301,19.1080060855,38,0,0,
La Vie d'Adèle  Chapitres 1 & 2,3652,5250000,2450504,22937201,-2799496,17687201,47.8673985869,18.6686140193,19.1095278173,3,0,0,
Hodejegerne,3653,5250000,1200010,20188740,-4049990,14938740,47.8673985869,18.6469313195,19.1032286047,14,0,0,
The Ten,3654,5250000,769726,786677,-4480274,-4463323,47.8673985869,18.4788262389,19.1010518925,4,0,0,
A Room for Romeo Brass,3655,5250000,20097,20097,-5229903,-5229903,47.8673985869,18.4715671762,19.0972483295,64,0,0,
Wilson,3656,5200000,2000000,2000000,-3200000,-3200000,47.7530192783,18.4906753723,19.1075146427,97,0,0,
Saint Ralph,3657,5200000,795126,1695126,-4404874,-3504874,47.7530192783,18.4878286827,19.1014336671,21,0,0,
Somewhere in Time,3658,5100000,9709597,9709597,4609597,4609597,47.5217629947,18.5609628902,19.1460575163,79,0,0,
My Big Fat Greek Wedding,3659,5000000,241438208,374890034,236438208,369890034,47.2870804502,19.9900053191,19.8985955977,93,0,0,
Paranormal Activity 3,3660,5000000,104028807,202053386,99028807,197053386,47.2870804502,19.5439974435,19.5225215753,50,0,0,
Saw II,3661,5000000,87025093,152925093,82025093,147925093,47.2870804502,19.3699238726,19.4643665286,70,0,0,
Insidious Chapter 2,3662,5000000,83586447,161921515,78586447,156921515,47.2870804502,19.4041505963,19.4521832727,59,0,0,
The Visit,3663,5000000,65112020,95749084,60112020,90749084,47.2870804502,19.1198066463,19.3840586326,37,0,0,
Jackass: The Movie,3664,5000000,64282312,79282312,59282312,74282312,47.2870804502,19.0344196831,19.3808874299,81,0,0,
Paranormal Activity 4,3665,5000000,53900335,140096503,48900335,135096503,47.2870804502,19.3189978944,19.3403324455,94,0,0,
Ouija,3666,5000000,50856010,103474009,45856010,98474009,47.2870804502,19.1574823089,19.3281217564,84,0,0,
A Nightmare On Elm Street 3: Dream Warriors,3667,5000000,44793222,44793222,39793222,39793222,47.2870804502,18.8277676297,19.3033507523,39,0,0,
No se Aceptan Devoluciones,3668,5000000,44467206,100486616,39467206,95486616,47.2870804502,19.1430801653,19.3020011892,48,0,0,
The Gift,3669,5000000,43787265,58978653,38787265,53978653,47.2870804502,18.9179887855,19.2991806577,22,0,0,
The Return of the Pink Panther,3670,5000000,41833347,41833347,36833347,36833347,47.2870804502,18.8078704632,19.2910308535,0,0,0,
The Robe,3671,5000000,36000000,36000000,31000000,31000000,47.2870804502,18.7674585666,19.2662971387,76,0,0,
Monster,3672,5000000,34469210,64240813,29469210,59240813,47.2870804502,18.9494900182,19.2597038817,66,0,0,
Freddy's Dead: The Final Nightmare,3673,5000000,34015591,34015591,29015591,29015591,47.2870804502,18.7533302046,19.257741723,93,0,0,
Paranormal Activity: The Marked Ones,3674,5000000,32462372,86362372,27462372,81362372,47.2870804502,19.0720294847,19.2509938611,71,0,0,
Oculus,3676,5000000,27695246,44115496,22695246,39115496,47.2870804502,18.8232465733,19.2299943965,12,0,0,
Dallas Buyers Club,3677,5000000,27298285,56238045,22298285,51238045,47.2870804502,18.9011808854,19.2282257078,100,0,0,
No Escape,3678,5000000,27288872,39155092,22288872,34155092,47.2870804502,18.789518755,19.2281837295,18,0,0,
The Elephant Man,3679,5000000,26010864,26010864,21010864,21010864,47.2870804502,18.694221594,19.2224678894,54,0,0,
The Lazarus Effect,3680,5000000,25801570,28101570,20801570,23101570,47.2870804502,18.7100000655,19.2215287091,5,0,0,
Memento,3681,5000000,25530884,39709113,20530884,34709113,47.2870804502,18.793342697,19.2203127305,58,0,0,
Our Idiot Brother,3682,5000000,24814830,25861249,19814830,20861249,47.2870804502,18.6930828527,19.2170889173,71,0,0,
Clerks II,3683,5000000,24148068,27342246,19148068,22342246,47.2870804502,18.7042982272,19.2140776529,81,0,0,
The Players Club,3684,5000000,23031390,23031390,18031390,18031390,47.2870804502,18.6712965105,19.2090140558,84,0,0,
Billy Elliot,3685,5000000,21995263,109280263,16995263,104280263,47.2870804502,19.1848943348,19.2042926751,59,0,0,
The Way Way Back,3686,5000000,21502690,26853810,16502690,21853810,47.2870804502,18.7006132561,19.2020402971,61,0,0,
"As Above, So Below",3687,5000000,21222315,41799626,16222315,36799626,47.2870804502,18.8076414841,19.2007559631,30,0,0,
The Apostle,3688,5000000,20733485,21277770,15733485,16277770,47.2870804502,18.6575537101,19.1985127915,100,0,0,
The Man From Snowy River,3689,5000000,20659423,20659423,15659423,15659423,47.2870804502,18.6526624436,19.1981724921,27,0,0,
House Party 2,3690,5000000,19438638,19438638,14438638,14438638,47.2870804502,18.64293494,19.1925464898,41,0,0,
Doug's 1st Movie,3691,5000000,19421271,19421271,14421271,14421271,47.2870804502,18.6427958707,19.192466225,46,0,0,
Still Alice,3692,5000000,18656400,41699612,13656400,36699612,47.2870804502,18.8069620405,19.1889248265,92,0,0,
Mommie Dearest,3693,5000000,17988509,23988509,12988509,18988509,47.2870804502,18.678718362,19.1858221608,11,0,0,
Apollo 18,3694,5000000,17686929,26517819,12686929,21517819,47.2870804502,18.6980704892,19.1844180198,28,0,0,
Addicted,3695,5000000,17390770,17499242,12390770,12499242,47.2870804502,18.6272841299,19.1830371973,97,0,0,
Halloween 4: The Return of Michael Myers,3696,5000000,16634499,16634499,11634499,11634499,47.2870804502,18.62022596,19.1795024564,98,0,0,
O (Othello),3697,5000000,16017403,16017403,11017403,11017403,47.2870804502,18.6151584891,19.1766089209,51,0,0,
Halloween:  The Curse of Michael Myers,3698,5000000,15106362,15106362,10106362,10106362,47.2870804502,18.6076299434,19.1723217272,17,0,0,
The Egyptian,3699,5000000,15000000,15000000,10000000,10000000,47.2870804502,18.6067472962,19.1718200066,3,0,0,
Eve's Bayou,3700,5000000,14821531,14821531,9821531,9821531,47.2870804502,18.6052645151,19.1709775839,39,0,0,
Nighthawks,3701,5000000,14600000,19600000,9600000,14600000,47.2870804502,18.6442261506,19.1699309086,63,0,0,
Friday the 13th Part VIII: Jason Takes Manhattan,3702,5000000,14343976,14343976,9343976,9343976,47.2870804502,18.6012859788,19.1687198967,63,0,0,
Spring Breakers,3703,5000000,14124286,31149251,9124286,26149251,47.2870804502,18.7325637936,19.1676795768,47,0,0,
Y Tu Mamá También,3704,5000000,13649881,33649881,8649881,28649881,47.2870804502,18.7507045412,19.165429381,38,0,0,
Shaun of the Dead,3705,5000000,13464388,30253899,8464388,25253899,47.2870804502,18.7259876403,19.1645481725,11,0,0,
The Haunting of Molly Hartley,3706,5000000,13442412,15318257,8442412,10318257,47.2870804502,18.6093860397,19.1644437212,57,0,0,
Lone Star,3707,5000000,12952403,12952403,7952403,7952403,47.2870804502,18.5896016198,19.1621118844,98,0,0,
April Fool's Day,3708,5000000,12947763,12947763,7947763,7947763,47.2870804502,18.5895624307,19.1620897778,0,0,0,
Diner,3709,5000000,12592907,12592907,7592907,7592907,47.2870804502,18.5865607852,19.1603976635,53,0,0,
Lone Wolf McQuade,3710,5000000,12232628,12232628,7232628,7232628,47.2870804502,18.5835040222,19.1586767557,18,0,0,
Sunshine Cleaning,3711,5000000,12062558,17329337,7062558,12329337,47.2870804502,18.6259012651,19.1578633696,29,0,0,
A Farewell To Arms,3712,5000000,11000000,11000000,6000000,6000000,47.2870804502,18.5729746325,19.1527664873,100,0,0,
Solomon and Sheba,3713,5000000,11000000,11000000,6000000,6000000,47.2870804502,18.5729746325,19.1527664873,85,0,0,
The Beastmaster,3714,5000000,10751126,10751126,5751126,5751126,47.2870804502,18.5708351752,19.1515689233,37,0,0,
Not Easily Broken,3715,5000000,10572742,10732909,5572742,5732909,47.2870804502,18.570678392,19.1507096689,63,0,0,
Moms Night Out,3716,5000000,10429707,10537341,5429707,5537341,47.2870804502,18.5689937003,19.1500201526,57,0,0,
Digimon: The Movie,3717,5000000,9628751,16628751,4628751,11628751,47.2870804502,18.6201788769,19.1461502446,79,0,0,
Saved!,3718,5000000,8886160,10206551,3886160,5206551,47.2870804502,18.5661376826,19.1425489051,74,0,0,
Les invasions barbares,3719,5000000,8460000,8460000,3460000,3460000,47.2870804502,18.5509213454,19.1404762868,36,0,0,
Robin and Marian,3720,5000000,8000000,8000000,3000000,3000000,47.2870804502,18.5468749024,19.1382342572,46,0,0,
Force 10 from Navarone,3721,5000000,7100000,7100000,2100000,2100000,47.2870804502,18.5389102756,19.1338330853,82,0,0,
The Forsaken,3722,5000000,6755271,6755271,1755271,1755271,47.2870804502,18.5358426854,19.1321421506,43,0,0,
UHF,3723,5000000,6157157,6157157,1157157,1157157,47.2870804502,18.5304979051,19.1292015327,21,0,0,
Sea Rex 3D: Journey to a Prehistoric World,3724,5000000,6096582,16515203,1096582,11515203,47.2870804502,18.619248325,19.1289032339,1,0,0,
Grandma's Boy,3725,5000000,6090172,6590172,1090172,1590172,47.2870804502,18.5343702035,19.128871663,61,0,0,
Slums of Beverly Hills,3726,5000000,5480318,5480318,480318,480318,47.2870804502,18.524414978,19.1258634018,35,0,0,
C'era una volta il West,3727,5000000,5321508,5321508,321508,321508,47.2870804502,18.522982336,19.1250785433,22,0,0,
Made,3728,5000000,5308707,5476060,308707,476060,47.2870804502,18.5243765929,19.1250152524,81,0,0,
La mala educación,3729,5000000,5211842,40311842,211842,35311842,47.2870804502,18.7974862889,19.1245362008,3,0,0,
Moon,3730,5000000,5010163,10676073,10163,5676073,47.2870804502,18.5701890791,19.1235380483,97,0,0,
Keeping Up with the Steins,3731,5000000,4339241,4414753,-660759,-585247,47.2870804502,18.5147628519,19.1202103237,25,0,0,
The Sweet Hereafter,3732,5000000,4306697,7951247,-693303,2951247,47.2870804502,18.5464450798,19.1200486258,69,0,0,
Bottle Shock,3733,5000000,4048523,4785806,-951477,-214194,47.2870804502,18.5181345156,19.1187649374,44,0,0,
Des Hommes et Des Dieux,3734,5000000,3954651,46263525,-1045349,41263525,47.2870804502,18.8375061918,19.1182977799,62,0,0,
Jekyll and Hyde... Together Again,3735,5000000,3707583,3707583,-1292417,-1292417,47.2870804502,18.5083053288,19.1170671925,80,0,0,
Heavenly Creatures,3736,5000000,2932067,5324101,-2067933,324101,47.2870804502,18.5230057442,19.1131946641,29,0,0,
Everything Must Go,3737,5000000,2712131,2821010,-2287869,-2178990,47.2870804502,18.500150229,19.1120936816,64,0,0,
Kill the Messenger,3738,5000000,2450846,2767998,-2549154,-2232002,47.2870804502,18.499660487,19.1107841319,88,0,0,
Rabbit Hole,3739,5000000,2229058,5839592,-2770942,839592,47.2870804502,18.5276484734,19.1096711923,90,0,0,
Zero Effect,3740,5000000,1980338,1980338,-3019662,-3019662,47.2870804502,18.4923554296,19.1084216319,24,0,0,
The Machinist,3741,5000000,1082044,8655397,-3917956,3655397,47.2870804502,18.5526352353,19.1038955868,83,0,0,
Light Sleeper,3742,5000000,1050861,1050861,-3949139,-3949139,47.2870804502,18.4836659,19.1037381031,97,0,0,
Atlas Shrugged: Who Is John Galt?,3743,5000000,851690,851690,-4148310,-4148310,47.2870804502,18.4817940182,19.1027316429,98,0,0,
Party Monster,3744,5000000,742898,894030,-4257102,-4105970,47.2870804502,18.4821922384,19.102181462,28,0,0,
The Oh in Ohio,3745,5000000,418689,648183,-4581311,-4351817,47.2870804502,18.4798777591,19.1005400809,9,0,0,
Bottle Rocket,3746,5000000,407488,407488,-4592512,-4592512,47.2870804502,18.4776065808,19.1004833251,80,0,0,
Albino Alligator,3747,5000000,326308,326308,-4673692,-4673692,47.2870804502,18.4768394083,19.1000718876,38,0,0,
"Gandhi, My Father",3748,5000000,240425,1375194,-4759575,-3624806,47.2870804502,18.486706621,19.09963643,56,0,0,
Standard Operating Procedure,3749,5000000,228830,228830,-4771170,-4771170,47.2870804502,18.475917437,19.0995776246,44,0,0,
Tucker & Dale vs. Evil,3750,5000000,223838,5476793,-4776162,476793,47.2870804502,18.5243832009,19.0995523061,87,0,0,
No Looking Back,3751,5000000,143273,143273,-4856727,-4856727,47.2870804502,18.4751075165,19.0991436057,57,0,0,
"Lovely, Still",3752,5000000,127564,127564,-4872436,-4872436,47.2870804502,18.4749587368,19.0990638957,79,0,0,
Tycoon,3753,5000000,121016,121016,-4878984,-4878984,47.2870804502,18.4748967143,19.0990306682,43,0,0,
Desert Blue,3754,5000000,99147,99147,-4900853,-4900853,47.2870804502,18.4746895436,19.098919687,95,0,0,
Decoys,3755,5000000,84733,96760,-4915267,-4903240,47.2870804502,18.4746669283,19.0988465318,93,0,0,
Stuck,3756,5000000,67505,67505,-4932495,-4932495,47.2870804502,18.4743897148,19.0987590878,59,0,0,
Redacted,3757,5000000,65388,861325,-4934612,-4138675,47.2870804502,18.4818846522,19.098748342,50,0,0,
Rudderless,3758,5000000,56001,56001,-4943999,-4943999,47.2870804502,18.4742806846,19.0987006928,23,0,0,
Fascination,3759,5000000,16066,82752,-4983934,-4917248,47.2870804502,18.4745342014,19.0984979537,5,0,0,
Grace,3760,5000000,8297,8297,-4991703,-4991703,47.2870804502,18.4738284385,19.0984585079,44,0,0,
Obsluhoval jsem anglického krále,3781,4900000,617228,7174984,-4282772,2274984,47.0488508055,18.5404637872,19.1020516,12,0,0,
Soul Kitchen,3782,4900000,276901,23347469,-4623099,18447469,47.0488508055,18.6745297099,19.1003283236,90,0,0,
The Awakening,3783,4900000,95933,6924321,-4804067,2024321,47.0488508055,18.5382376475,19.099410765,32,0,0,
All Hat,3784,4900000,15198,15198,-4884802,-4884802,47.0488508055,18.474841603,19.0990011441,0,0,0,
Sling Blade,3785,4833610,24475416,34175000,19641806,29341390,46.8886686484,18.7556635291,19.2163083683,30,0,0,
Hostel,3786,4800000,47326473,82241110,42526473,77441110,46.8069463864,19.0513744389,19.3145941364,31,0,0,
Take Shelter,3787,4750000,1728953,4972016,-3021047,222016,46.6845742379,18.5220837611,19.1084146693,34,0,0,
Tristram Shandy: A Cock and Bull Story,3788,4750000,1253413,3061763,-3496587,-1688237,46.6845742379,18.5046726127,19.1060212012,86,0,0,
The Texas Chainsaw Massacre 2,3789,4700000,8025872,8025872,3325872,3325872,46.5612321451,18.5497431632,19.139823069,100,0,0,
Lady in White,3790,4700000,1705139,1705139,-2994861,-2994861,46.5612321451,18.492586259,19.1085463013,31,0,0,
Driving Lessons,3791,4700000,239962,239962,-4460038,-4460038,46.5612321451,18.4788572328,19.1011543682,51,0,0,
Pat Garrett and Billy the Kid,3794,4638783,8000000,11000000,3361217,6361217,46.4088721614,18.5760717315,19.1399952444,73,0,0,
Camping Sauvage,3795,4600000,3479302,3479302,-1120698,-1120698,46.311565067,18.5098772186,19.1179226447,47,0,0,
Barfi,3796,4600000,2804874,36751984,-1795126,32151984,46.311565067,18.775569676,19.1145586325,24,0,0,
Dear Frankie,3797,4600000,1340891,3147385,-3259109,-1452615,46.311565067,18.5068366694,19.1072171817,76,0,0,
Le nom des gens,3798,4600000,514237,9261711,-4085763,4661711,46.311565067,18.5614157172,19.1030478174,72,0,0,
Savage Grace,3799,4600000,434417,968805,-4165583,-3631195,46.311565067,18.4866468114,19.1026443104,93,0,0,
Out of the Blue,3800,4600000,728,731767,-4599272,-3868233,46.311565067,18.4844252844,19.1004490705,25,0,0,
Police Academy,3801,4500000,81198894,81198894,76698894,76698894,46.057793516,19.0474163757,19.4454319557,89,0,0,
Four Weddings and a Funeral,3802,4500000,52086062,242281039,47586062,237781039,46.057793516,19.6683774176,19.3350792187,60,0,0,
The Blue Lagoon,3803,4500000,47923795,47923795,43423795,43423795,46.057793516,18.8516448842,19.3182579286,72,0,0,
Fast Times at Ridgemont High,3804,4500000,27092880,27092880,22592880,22592880,46.057793516,18.7061838593,19.2295385966,39,0,0,
Secrets & Lies,3805,4500000,13417292,13417292,8917292,8917292,46.057793516,18.5977178125,19.1666983863,1,0,0,
25th Hour,3806,4500000,13084595,25344490,8584595,20844490,46.057793516,18.6929552167,19.1651193199,0,0,0,
Moby Dick,3807,4500000,10400000,10400000,5900000,5900000,46.057793516,18.5721155277,19.1522854668,1,0,0,
Bound,3808,4500000,3798532,7007589,-701468,2507589,46.057793516,18.5425251301,19.1200080532,88,0,0,
Requiem for a Dream,3809,4500000,3635482,7390108,-864518,2890108,46.057793516,18.5459057968,19.1191974976,79,0,0,
State Fair,3810,4500000,3500000,3500000,-1000000,-1000000,46.057793516,18.5109805931,19.1185234881,18,0,0,
Låt den rätte komma in,3811,4500000,2122085,12247682,-2377915,7747682,46.057793516,18.5878710994,19.1116425684,26,0,0,
Tango,3812,4500000,1687311,5428387,-2812689,928387,46.057793516,18.5284460269,19.1094615659,68,0,0,
Salvador,3813,4500000,1500000,1500000,-3000000,-3000000,46.057793516,18.4925384334,19.1085204699,49,0,0,
Salvando al Soldado Perez,3814,4500000,1400726,9330465,-3099274,4830465,46.057793516,18.5628806426,19.1080213339,11,0,0,
Donnie Darko,3815,4500000,1270522,7301393,-3229478,2801393,46.057793516,18.5451227594,19.1073663082,91,0,0,
Karakter,3816,4500000,713413,713413,-3786587,-3786587,46.057793516,18.4851910304,19.1045587684,49,0,0,
Nannerl la soeur de Mozart,3817,4500000,707885,2404639,-3792115,-2095361,46.057793516,18.5009223335,19.1045308706,69,0,0,
Spun,3818,4500000,410241,1022649,-4089759,-3477351,46.057793516,18.4880860053,19.1030276207,97,0,0,
Life During Wartime,3819,4500000,281447,281447,-4218553,-4218553,46.057793516,18.4811330122,19.102376446,26,0,0,
Chinjeolhan geumjassi,3820,4500000,211667,23471871,-4288333,18971871,46.057793516,18.6785898142,19.1020234653,14,0,0,
Blackthorn,3821,4500000,200558,1217307,-4299442,-3282693,46.057793516,18.4899040463,19.1019672591,99,0,0,
Maggie,3822,4500000,187112,597989,-4312888,-3902011,46.057793516,18.4841083139,19.1018992247,63,0,0,
Lilja 4-ever,3823,4500000,181655,4556982,-4318345,56982,46.057793516,18.5205914524,19.1018716119,53,0,0,
After.Life,3824,4500000,108596,2481925,-4391404,-2018075,46.057793516,18.5016353466,19.1015018547,33,0,0,
Mean Machine,3825,4500000,92723,92723,-4407277,-4407277,46.057793516,18.4793549002,19.1014215022,91,0,0,
Fong juk,3826,4500000,51957,51957,-4448043,-4448043,46.057793516,18.4789703972,19.1012151063,47,0,0,
The Sweeney,3827,4500000,26345,2532091,-4473655,-1967909,46.057793516,18.5020978883,19.1010854125,30,0,0,
Falcon Rising,3828,4500000,11774,11774,-4488226,-4488226,46.057793516,18.4785912483,19.1010116205,15,0,0,
One Flew Over the Cuckoo's Nest,3832,4400000,108981275,108981275,104581275,104581275,45.7997565096,19.1862951661,19.5408020333,14,0,0,
Silent Movie,3833,4400000,36145695,36145695,31745695,31745695,45.7997565096,18.7727165026,19.2694932396,90,0,0,
Whale Rider,3836,4300000,20779666,39374600,16479666,35074600,45.5372829156,18.7958573655,19.2019348916,15,0,0,
Sexy Beast,3837,4300000,6946056,10158355,2646056,5858355,45.5372829156,18.5717575357,19.1365057136,62,0,0,
Paa,3838,4300000,199228,9791282,-4100772,5491282,45.5372829156,18.5685965186,19.1029719562,90,0,0,
Snabba Cash,3839,4300000,188870,10212403,-4111130,5912403,45.5372829156,18.5722221226,19.1029195995,43,0,0,
Nochnoy dozor,3841,4200000,1499188,33910542,-2700812,29710542,45.2701905584,18.7583007788,19.1100232409,32,0,0,
Animal Kingdom,3842,4200000,1044039,8078683,-3155961,3878683,45.2701905584,18.554590159,19.1077362077,72,0,0,
George A. Romero's Survival of the Dead,3843,4200000,101740,101740,-4098260,-4098260,45.2701905584,18.4822647361,19.1029846532,10,0,0,
Love and Death on Long Island,3846,4030000,2542264,2542264,-1487736,-1487736,44.8049772903,18.5065143995,19.1160932817,41,0,0,
Porky's,3847,4000000,105124546,105124546,101124546,101124546,44.72135955,19.1700891016,19.5294607227,22,0,0,
Peter Pan,3848,4000000,87400000,87400000,83400000,83400000,44.72135955,19.0825964705,19.4691966392,31,0,0,
The Crying Game,3849,4000000,61587055,61587055,57587055,57587055,44.72135955,18.9396965187,19.3743766034,97,0,0,
Lost in Translation,3850,4000000,44585453,117085297,40585453,113085297,44.72135955,19.2250809706,19.3066226705,87,0,0,
Annie Hall,3851,4000000,38251425,38251425,34251425,34251425,44.72135955,18.790184712,19.28015875,1,0,0,
The Greatest Show on Earth,3852,4000000,36000000,36000000,32000000,32000000,44.72135955,18.7745033178,19.270580877,49,0,0,
The Boy Next Door,3853,4000000,35423380,52426530,31423380,48426530,44.72135955,18.8836394409,19.2681130282,72,0,0,
Leaving Las Vegas,3854,4000000,31921127,49737350,27921127,45737350,44.72135955,18.8665683557,19.2529916359,18,0,0,
Monster's Ball,3855,4000000,31273922,43766463,27273922,39766463,44.72135955,18.8275895096,19.2501720459,26,0,0,
Boyhood,3856,4000000,25379975,50689197,21379975,46689197,44.72135955,18.8726441157,19.2241220818,86,0,0,
Exodus,3857,4000000,21750000,21750000,17750000,17750000,44.72135955,18.6691039902,19.2077340328,22,0,0,
The Kids Are All Right,3858,4000000,20811365,36275469,16811365,32275469,44.72135955,18.7764352415,19.203452362,17,0,0,
The Life of Brian,3859,4000000,20008693,20008693,16008693,16008693,44.72135955,18.655428189,19.1997763009,61,0,0,
A Haunted House 2,3860,4000000,17329487,21206861,13329487,17206861,44.72135955,18.6648583445,19.1874073656,73,0,0,
The Last Exorcism Part II,3861,4000000,15179303,25448707,11179303,21448707,44.72135955,18.6975466496,19.1773688733,36,0,0,
The Front Page,3862,4000000,15000000,15000000,11000000,11000000,44.72135955,18.6150152061,19.1765271975,9,0,0,
Trapeze,3863,4000000,14400000,14400000,10400000,10400000,44.72135955,18.6100626677,19.1737055427,45,0,0,
The Return of the Living Dead,3864,4000000,14237880,14237880,10237880,10237880,44.72135955,18.608720272,19.1729417634,97,0,0,
They Live,3865,4000000,13000000,13000000,9000000,9000000,44.72135955,18.5984104578,19.1670905533,62,0,0,
Saving Grace,3866,4000000,12178602,27786849,8178602,23786849,44.72135955,18.7151181304,19.1631889876,19,0,0,
The Great Escape,3867,4000000,11744471,11744471,7744471,7744471,44.72135955,18.5878439327,19.1611207397,66,0,0,
What the #$'! Do We Know,3868,4000000,10941801,10941801,6941801,6941801,44.72135955,18.5810296863,19.1572854287,10,0,0,
Scoop,3869,4000000,10525717,40107018,6525717,36107018,44.72135955,18.8029267634,19.1552914956,93,0,0,
The Wash,3870,4000000,10097096,10097096,6097096,6097096,44.72135955,18.5738080833,19.1532333178,31,0,0,
3 Strikes,3871,4000000,9821335,9821335,5821335,5821335,44.72135955,18.5714391939,19.1519069093,66,0,0,
The Visitor,3872,4000000,9427026,19174817,5427026,15174817,44.72135955,18.6488123065,19.150007224,22,0,0,
The Cooler,3873,4000000,8243880,11083763,4243880,7083763,44.72135955,18.582238254,19.1442853569,54,0,0,
The Misfits,3874,4000000,8200000,8200000,4200000,4200000,44.72135955,18.5573966781,19.1440725159,86,0,0,
The Night Listener,3875,4000000,7836393,10770993,3836393,6770993,44.72135955,18.5795736048,19.1423070859,16,0,0,
The Jerky Boys,3876,4000000,7555256,7555256,3555256,3555256,44.72135955,18.5517572334,19.1409399349,54,0,0,
El orfanato,3877,4000000,7159147,79250193,3159147,75250193,44.72135955,19.0396453689,19.1390105049,81,0,0,
Bug,3878,4000000,7006708,8302995,3006708,4302995,44.72135955,18.5582946157,19.1382669879,37,0,0,
The Rules of Attraction,3879,4000000,6525762,11799060,2525762,7799060,44.72135955,18.5883056827,19.1359175572,41,0,0,
Topaz,3880,4000000,6000000,6000000,2000000,2000000,44.72135955,18.5380213885,19.1333428683,35,0,0,
Let's Go to Prison,3881,4000000,4630045,4630045,630045,630045,44.72135955,18.5257638042,19.1266028072,56,0,0,
Four Rooms,3882,4000000,4219131,4219131,219131,219131,44.72135955,18.5220576928,19.1245722569,27,0,0,
Secretary,3883,4000000,4046737,9413956,46737,5413956,44.72135955,18.5679293564,19.1237191349,31,0,0,
The Real Cancun,3884,4000000,3816594,3816594,-183406,-183406,44.72135955,18.5184137682,19.1225790961,8,0,0,
Talk Radio,3885,4000000,3468572,3468572,-531428,-531428,44.72135955,18.5152525968,19.1208526582,2,0,0,
Waiting for Guffman,3886,4000000,2922988,2922988,-1077012,-1077012,44.72135955,18.5102767197,19.1181401585,26,0,0,
Love Stinks,3887,4000000,2793776,2793776,-1206224,-1206224,44.72135955,18.5090946354,19.1174966715,16,0,0,
Samsara,3888,4000000,2672413,5966671,-1327587,1966671,44.72135955,18.5377249557,19.1168918958,64,0,0,
You Kill Me,3889,4000000,2426851,3858964,-1573149,-141036,44.72135955,18.5187979441,19.1156670923,6,0,0,
The Art of Getting By,3890,4000000,1430241,1989035,-2569759,-2010965,44.72135955,18.5017009154,19.1106807875,53,0,0,
Thumbsucker,3891,4000000,1325073,1915591,-2674927,-2084409,44.72135955,18.5010234037,19.1101531508,7,0,0,
Red State,3892,4000000,1065429,1983596,-2934571,-2016404,44.72135955,18.501650757,19.1088493018,14,0,0,
MirrorMask,3893,4000000,864959,973613,-3135041,-3026387,44.72135955,18.4922928291,19.1078414413,92,0,0,
The Barbarians,3894,4000000,800000,800000,-3200000,-3200000,44.72135955,18.4906753723,19.1075146427,1,0,0,
Holy Motors,3895,4000000,641054,4230426,-3358946,230426,44.72135955,18.5221597484,19.1067145595,57,0,0,
Poolhall Junkies,3896,4000000,563711,563711,-3436289,-3436289,44.72135955,18.4884697859,19.1063250079,23,0,0,
The Loss of Sexual Innocence,3897,4000000,399793,399793,-3600207,-3600207,44.72135955,18.4869368674,19.1054989044,47,0,0,
Joe,3898,4000000,373375,373375,-3626625,-3626625,44.72135955,18.4866895931,19.1053657007,72,0,0,
Prison,3899,4000000,354704,354704,-3645296,-3645296,44.72135955,18.4865147944,19.105271548,52,0,0,
Shooting Fish,3900,4000000,302204,302204,-3697796,-3697796,44.72135955,18.4860231233,19.1050067572,78,0,0,
Adoration,3901,4000000,294244,384244,-3705756,-3615756,44.72135955,18.4867913351,19.1049666038,86,0,0,
Psycho Beach Party,3902,4000000,267972,267972,-3732028,-3732028,44.72135955,18.4857024047,19.1048340658,72,0,0,
The Big Tease,3903,4000000,185577,185577,-3814423,-3814423,44.72135955,18.4849300265,19.1044182824,49,0,0,
Desert Dancer,3904,4000000,155271,192093,-3844729,-3807907,44.72135955,18.4849911298,19.1042653081,91,0,0,
"Guten Tag, Ramon",3905,4000000,154356,4854356,-3845644,854356,44.72135955,18.5277811273,19.1042606892,47,0,0,
Mondays in the Sun,3906,4000000,146402,146402,-3853598,-3853598,44.72135955,18.4845625871,19.104220536,9,0,0,
Trust,3907,4000000,120016,120016,-3879984,-3879984,44.72135955,18.4843150252,19.1040873236,25,0,0,
An Everlasting Piece,3908,4000000,75078,75078,-3924922,-3924922,44.72135955,18.4838932614,19.1038604085,94,0,0,
Among Giants,3909,4000000,64359,64359,-3935641,-3935641,44.72135955,18.4837926324,19.1038062752,8,0,0,
The Velocity of Gary,3910,4000000,34145,34145,-3965855,-3965855,44.72135955,18.4835089315,19.1036536719,91,0,0,
Stake Land,3911,4000000,33245,679482,-3966755,-3320518,44.72135955,18.489551032,19.1036491259,20,0,0,
Praia do Futuro,3912,4000000,20620,20620,-3979380,-3979380,44.72135955,18.4833819095,19.1035853531,21,0,0,
Sonny,3913,4000000,17639,17639,-3982361,-3982361,44.72135955,18.4833539109,19.1035702945,21,0,0,
The Last Time I Committed Suicide,3914,4000000,12836,12836,-3987164,-3987164,44.72135955,18.4833087977,19.1035460316,10,0,0,
Another Happy Day,3915,4000000,9120,978527,-3990880,-3021473,44.72135955,18.492338572,19.1035272594,79,0,0,
Inescapable,3916,4000000,4327,4327,-3995673,-3995673,44.72135955,18.48322887,19.103503046,4,0,0,
Gone with the Wind,3930,3900000,198680470,390525192,194780470,386625192,44.4391917772,20.0242523512,19.7987458147,61,0,0,
A Man for All Seasons,3931,3900000,28350000,28350000,24450000,24450000,44.4391917772,18.7200461152,19.2377755688,46,0,0,
Ben-Hur,3932,3900000,9000000,9000000,5100000,5100000,44.4391917772,18.5652159891,19.1484289497,100,0,0,
Network,3933,3800000,23689877,23689877,19889877,19889877,44.1515443553,18.6856578919,19.2174272813,34,0,0,
Down for Life,3934,3800000,41914,41914,-3758086,-3758086,44.1515443553,18.4854581991,19.1047025901,96,0,0,
The Good Heart,3935,3800000,20930,340930,-3779070,-3459070,44.1515443553,18.4882568844,19.1045967026,25,0,0,
Major Dundee,3936,3800000,14873,14873,-3785127,-3785127,44.1515443553,18.4852047182,19.1045661363,88,0,0,
Annie Get Your Gun,3937,3768785,8000000,8000000,4231215,4231215,44.0605932809,18.5576689039,19.1442239296,30,0,0,
Casa de Areia,3938,3750000,539285,1178175,-3210715,-2571825,44.0055868397,18.4965153825,19.1074607269,67,0,0,
Four Lions,3939,3750000,310007,2436111,-3439993,-1313889,44.0055868397,18.5081086035,19.1063063483,72,0,0,
Defendor,3940,3750000,44462,44462,-3705538,-3705538,44.0055868397,18.4859505977,19.1049677035,58,0,0,
The Ballad of Cable Hogue,3941,3716946,3500000,5000000,-216946,1283054,43.9082939434,18.5316253039,19.1224128435,5,0,0,
The Pirate,3942,3700000,2956000,2956000,-744000,-744000,43.8581623665,18.5133168244,19.119796681,92,0,0,
The History Boys,3943,3700000,2706659,13424361,-993341,9724361,43.8581623665,18.6044562683,19.1185566266,80,0,0,
Unknown,3944,3700000,26403,3355048,-3673597,-344952,43.8581623665,18.5169476479,19.1051288168,6,0,0,
Midnight Cowboy,3945,3600000,44785053,44785053,41185053,41185053,43.5587717469,18.8369888208,19.3090919238,19,0,0,
Airplane!,3946,3500000,83453539,83453539,79953539,79953539,43.2530772707,19.0646575384,19.4570447225,39,0,0,
M*A*S*H,3947,3500000,81600000,81600000,78100000,78100000,43.2530772707,19.0548750652,19.4504477253,82,0,0,
The Full Monty,3948,3500000,45857453,257845980,42357453,254345980,43.2530772707,19.7148494598,19.3139025178,51,0,0,
Menace II Society,3949,3500000,27731527,27731527,24231527,24231527,43.2530772707,18.7184252871,19.2368100791,86,0,0,
Friday,3950,3500000,27409510,27878724,23909510,24378724,43.2530772707,18.7195176147,19.2353852995,85,0,0,
Empire,3951,3500000,17504595,18495444,14004595,14995444,43.2530772707,18.6473834421,19.1905385455,5,0,0,
Dark Skies,3952,3500000,17418667,27704111,13918667,24204111,43.2530772707,18.718221705,19.1901405518,7,0,0,
Creepshow 2,3953,3500000,14000000,14000000,10500000,10500000,43.2530772707,18.6108897959,19.1741763718,98,0,0,
In Cold Blood,3954,3500000,13000000,13007551,9500000,9507551,43.2530772707,18.602650514,19.1694580759,63,0,0,
The Nun's Story,3955,3500000,12800000,12800000,9300000,9300000,43.2530772707,18.6009188152,19.1685117394,83,0,0,
Frenzy,3956,3500000,12600000,12600000,9100000,9100000,43.2530772707,18.5992472762,19.1675645064,94,0,0,
Harper,3957,3500000,12000000,12000000,8500000,8500000,43.2530772707,18.5942158293,19.1647174122,16,0,0,
I Got the Hook-Up!,3958,3500000,10305534,10305534,6805534,6805534,43.2530772707,18.5798682264,19.1566328558,71,0,0,
She's the One,3959,3500000,9398667,13711141,5898667,10211141,43.2530772707,18.608498693,19.1522790532,90,0,0,
Terror Train,3960,3500000,8000000,8000000,4500000,4500000,43.2530772707,18.5600099145,19.1455267702,8,0,0,
El secreto de sus ojos,3961,3500000,6391436,40527719,2891436,37027719,43.2530772707,18.8091893057,19.1377043847,91,0,0,
Gods and Monsters,3962,3500000,6390032,6390032,2890032,2890032,43.2530772707,18.5459051263,19.1376975303,85,0,0,
Evil Dead II,3963,3500000,5923044,5923044,2423044,2423044,43.2530772707,18.5417763847,19.1354150616,56,0,0,
Day of the Dead,3964,3500000,5804262,34004262,2304262,30504262,43.2530772707,18.7639477297,19.1348336661,51,0,0,
Pootie Tang,3965,3500000,3293258,3293258,-206742,-206742,43.2530772707,18.5182021137,19.1224634261,78,0,0,
La otra conquista,3966,3500000,886410,886410,-2613590,-2613590,43.2530772707,18.4961281587,19.1104609176,19,0,0,
Trolljegeren,3967,3500000,253444,5706638,-3246556,2206638,43.2530772707,18.5398572972,19.107280361,19,0,0,
Ira and Abby,3968,3500000,221096,221096,-3278904,-3278904,43.2530772707,18.4899394015,19.1071175452,37,0,0,
Winter Passing,3969,3500000,106634,112925,-3393366,-3387075,43.2530772707,18.4889295641,19.1065412159,25,0,0,
D.E.B.S.,3970,3500000,96793,96793,-3403207,-3403207,43.2530772707,18.4887788754,19.1064916498,74,0,0,
Surveillance,3971,3500000,27349,1396395,-3472651,-2103605,43.2530772707,18.5008462473,19.1061418119,50,0,0,
Taxman,3972,3500000,9871,9871,-3490129,-3490129,43.2530772707,18.4879665473,19.1060537438,34,0,0,
Jagten,3981,3450000,687185,18309793,-2762815,14859793,43.097767484,18.6463015045,19.1097119957,9,0,0,
La marche de l'empereur,3983,3400000,77437223,133276359,74037223,129876359,42.9407602571,19.2975093937,19.4358336816,12,0,0,
High Anxiety,3984,3400000,31063038,31063038,27663038,27663038,42.9407602571,18.743584776,19.2518682075,19,0,0,
Margin Call,3985,3400000,5353586,20433227,1953586,17033227,42.9407602571,18.6634972593,19.1331152574,93,0,0,
Choke,3986,3400000,2926565,4124277,-473435,724277,42.9407602571,18.5266117679,19.121140552,17,0,0,
L'incomparable mademoiselle C.,3987,3400000,493905,493905,-2906095,-2906095,42.9407602571,18.4934119911,19.1089923821,18,0,0,
August,3988,3400000,11762,11762,-3388238,-3388238,42.9407602571,18.4889187013,19.106567043,11,0,0,
Whiplash,3990,3300000,13092006,33474334,9792006,30174334,42.6214759535,18.7616043159,19.1708381494,70,0,0,
Bella,3991,3300000,8093373,12405473,4793373,9105473,42.6214759535,18.5992930551,19.1469468577,86,0,0,
Cidade de Deus,3992,3300000,7563397,32059295,4263397,28759295,42.6214759535,18.7514908165,19.14438001,20,0,0,
Human Traffic,3993,3300000,104257,5422740,-3195743,2122740,42.6214759535,18.5391122983,19.1075360622,47,0,0,
The Dead Girl,3994,3300000,19875,19875,-3280125,-3280125,42.6214759535,18.4899280085,19.1071113991,82,0,0,
A Christmas Story,3996,3250000,20605209,20605209,17355209,17355209,42.4591054749,18.6660197517,19.2059353902,83,0,0,
Class of 1984,3997,3250000,6965361,6965361,3715361,3715361,42.4591054749,18.5531606103,19.1417187443,54,0,0,
Entre les murs,3998,3250000,3766810,34114067,516810,30864067,42.4591054749,18.7664971094,19.1260436627,24,0,0,
Dreaming of Joseph Lees,3999,3250000,7680,7680,-3242320,-3242320,42.4591054749,18.4902807032,19.1073016799,2,0,0,
Rosemary's Baby,4000,3200000,33395426,33395426,30195426,30195426,42.2948505376,18.7617542926,19.2628371828,26,0,0,
The Man Who Shot Liberty Valance,4001,3200000,8000000,8000000,4800000,4800000,42.2948505376,18.5626163397,19.1469789128,93,0,0,
Maria Full of Grace,4002,3200000,6529624,14441158,3329624,11241158,42.2948505376,18.61699889,19.1398413474,78,0,0,
Beginners,4003,3200000,5790894,14314407,2590894,11114407,42.2948505376,18.6159567699,19.1362360517,4,0,0,
Adam,4004,3200000,2277396,2828590,-922604,-371410,42.2948505376,18.5167073217,19.1189085811,70,0,0,
Feast,4005,3200000,56131,690872,-3143869,-2509128,42.2948505376,18.4970963957,19.1077970353,96,0,0,
It's a Wonderful Life,4006,3180000,6600000,6600000,3420000,3420000,42.2286093782,18.5505701301,19.1402815272,70,0,0,
Trainspotting,4007,3100000,16501000,71560987,13401000,68460987,41.9604776685,19.0024003135,19.1877395106,95,0,0,
National Lampoon's Animal House,4009,3000000,141600000,141600000,138600000,138600000,41.6179145029,19.3331652092,19.6460470301,18,0,0,
Paranormal Activity 2,4010,3000000,84752907,177512032,81752907,174512032,41.6179145029,19.4678673576,19.4634075542,88,0,0,
The Purge,4011,3000000,64473115,91265155,61473115,88265155,41.6179145029,19.1073841932,19.3892391522,77,0,0,
Goldfinger,4012,3000000,51100000,124900000,48100000,121900000,41.6179145029,19.2637564551,19.3371367462,3,0,0,
Sinister,4013,3000000,48086903,87727807,45086903,84727807,41.6179145029,19.0894227718,19.3250131553,89,0,0,
The Original Kings of Comedy,4014,3000000,38168022,38236338,35168022,35236338,41.6179145029,18.7969681599,19.2840319556,73,0,0,
The Bridge on the River Kwai,4015,3000000,33300000,33300000,30300000,30300000,41.6179145029,18.7624975444,19.2632875658,13,0,0,
Coming Home,4016,3000000,32653000,32653000,29653000,29653000,41.6179145029,18.7578901517,19.2604977827,23,0,0,
Waking Ned Devine,4017,3000000,24788807,55188807,21788807,52188807,41.6179145029,18.9070438801,19.2259510978,82,0,0,
Air Bud,4018,3000000,24629916,27771629,21629916,24771629,41.6179145029,18.7224274763,19.2252406551,98,0,0,
Bowling for Columbine,4019,3000000,21576018,58240487,18576018,55240487,41.6179145029,18.9256335304,19.2114868847,91,0,0,
A Nightmare On Elm Street Part 2: Freddy's Revenge,4020,3000000,21163999,21163999,18163999,18163999,41.6179145029,18.6723281024,19.2096167171,35,0,0,
A Room with a View,4021,3000000,20966644,20966644,17966644,17966644,41.6179145029,18.6707924516,19.2087196759,38,0,0,
Love and Death,4022,3000000,20123742,20123742,17123742,17123742,41.6179145029,18.664207021,19.204879335,32,0,0,
Martin Lawrence Live: RunTelDat,4023,3000000,19184820,19184820,16184820,16184820,41.6179145029,18.6568199804,19.2005840819,33,0,0,
The Apartment,4024,3000000,18600000,24600000,15600000,21600000,41.6179145029,18.6986930294,19.1978993721,6,0,0,
Friday the 13th Part VI: Jason Lives,4025,3000000,17834917,17834917,14834917,14834917,41.6179145029,18.6461029692,19.1943762182,99,0,0,
Cat on a Hot Tin Roof,4026,3000000,17570324,17570324,14570324,14570324,41.6179145029,18.6439888098,19.1931548915,73,0,0,
Beneath the Planet of the Apes,4027,3000000,17489009,17489009,14489009,14489009,41.6179145029,18.6433381852,19.1927792523,85,0,0,
Pokemon 3: The Movie,4028,3000000,17052128,68452128,14052128,65452128,41.6179145029,18.9854396832,19.1907586365,94,0,0,
Jason Goes to Hell: The Final Friday,4029,3000000,15935068,15935068,12935068,12935068,41.6179145029,18.6308226187,19.1855734859,100,0,0,
Spaced Invaders,4030,3000000,13654536,13654536,10654536,10654536,41.6179145029,18.6121666628,19.1749035364,52,0,0,
Family Plot,4031,3000000,13200000,13200000,10200000,10200000,41.6179145029,18.6084063559,19.1727632191,88,0,0,
Torn Curtain,4032,3000000,13000000,13000000,10000000,10000000,41.6179145029,18.6067472962,19.1718200066,11,0,0,
Dave Chappelle's Block Party,4033,3000000,11718595,12051924,8718595,9051924,41.6179145029,18.5988450548,19.1657556187,99,0,0,
Krush Groove,4034,3000000,11052713,11052713,8052713,8052713,41.6179145029,18.590448455,19.1625896788,25,0,0,
Elmer Gantry,4035,3000000,10400000,10400000,7400000,7400000,41.6179145029,18.5849252409,19.1594765927,53,0,0,
Next Day Air,4036,3000000,10027047,10172519,7027047,7172519,41.6179145029,18.5829931207,19.1576934492,40,0,0,
Judgment at Nuremberg,4037,3000000,10000000,10000000,7000000,7000000,41.6179145029,18.5815253296,19.1575640098,70,0,0,
Trippin',4038,3000000,9017070,9017070,6017070,6017070,41.6179145029,18.573121208,19.1528485744,83,0,0,
Red River,4039,3000000,9012000,9012000,6012000,6012000,41.6179145029,18.5730776755,19.1528241943,16,0,0,
The Deep End,4040,3000000,8823109,9981635,5823109,6981635,41.6179145029,18.5813689533,19.1519154478,43,0,0,
Before Midnight,4041,3000000,8110621,23376973,5110621,20376973,41.6179145029,18.6893880412,19.1484802473,62,0,0,
Teen Wolf Too,4042,3000000,7888000,7888000,4888000,4888000,41.6179145029,18.5633796042,19.1474044749,87,0,0,
Phat Girlz,4043,3000000,7061128,7301115,4061128,4301115,41.6179145029,18.5582782326,19.1433986151,40,0,0,
Phantasm II,4044,3000000,7000000,7000000,4000000,4000000,41.6179145029,18.5556507189,19.1431018367,56,0,0,
Woman Thou Art Loosed,4045,3000000,6879730,6879730,3879730,3879730,41.6179145029,18.5545993167,19.1425176648,0,0,0,
Real Women Have Curves,4046,3000000,5853194,7777790,2853194,4777790,41.6179145029,18.56242361,19.1375176686,51,0,0,
Gallipoli,4047,3000000,5732587,5732587,2732587,2732587,41.6179145029,18.544515025,19.136928578,26,0,0,
Water,4048,3000000,5529144,11322573,2529144,8322573,41.6179145029,18.5927231088,19.1359340976,28,0,0,
East is East,4049,3000000,4170647,30438635,1170647,27438635,41.6179145029,18.7419586797,19.1292679515,70,0,0,
Whipped,4050,3000000,4142507,4142507,1142507,1142507,41.6179145029,18.5303666328,19.1291293976,9,0,0,
Kama Sutra,4051,3000000,4109095,4109095,1109095,1109095,41.6179145029,18.5300671778,19.1289648609,35,0,0,
Please Give,4052,3000000,4033574,4570178,1033574,1570178,41.6179145029,18.5341917342,19.1285928595,9,0,0,
Willy Wonka & the Chocolate Factory,4053,3000000,4000000,4000000,1000000,1000000,41.6179145029,18.5290887893,19.1284274362,14,0,0,
Warlock: The Armageddon,4054,3000000,3902679,3902679,902679,902679,41.6179145029,18.528215184,19.1279477687,100,0,0,
8 Heads in a Duffel Bag,4055,3000000,3559990,3959990,559990,959990,41.6179145029,18.5287297305,19.1262569186,66,0,0,
Days of Heaven,4056,3000000,3446749,3660880,446749,660880,41.6179145029,18.5260413577,19.125697551,53,0,0,
Thirteen Conversations About One Thing,4057,3000000,3287435,3705923,287435,705923,41.6179145029,18.5264466625,19.1249100701,10,0,0,
Jawbreaker,4058,3000000,3076820,3076820,76820,76820,41.6179145029,18.520770954,19.1238680583,1,0,0,
Tsotsi,4059,3000000,2912606,11537539,-87394,8537539,41.6179145029,18.5945313652,19.1230548602,20,0,0,
Letters to God,4060,3000000,2848587,2908902,-151413,-91098,41.6179145029,18.5192505509,19.1227376548,91,0,0,
Happiness,4061,3000000,2746453,5746453,-253547,2746453,41.6179145029,18.5446375273,19.1222313864,20,0,0,
Basquiat,4062,3000000,2729067,2729067,-270933,-270933,41.6179145029,18.5176196785,19.1221451801,9,0,0,
DysFunkTional Family,4063,3000000,2255000,2255000,-745000,-745000,41.6179145029,18.5133077091,19.1197917108,60,0,0,
Tusk,4064,3000000,1821983,1821983,-1178017,-1178017,41.6179145029,18.5093528038,19.1176371801,53,0,0,
Damsels in Distress,4065,3000000,1007535,1324299,-1992465,-1675701,41.6179145029,18.5047878669,19.1135721719,74,0,0,
Oldboy,4066,3000000,707391,6239723,-2292609,3239723,41.6179145029,18.5489856963,19.1120699402,12,0,0,
Hobo with a Shotgun,4067,3000000,703372,834953,-2296628,-2165047,41.6179145029,18.5002789991,19.1120498097,17,0,0,
Bachelorette,4068,3000000,446770,12577401,-2553230,9577401,41.6179145029,18.6032326326,19.1107636896,37,0,0,
Fish Tank,4069,3000000,374675,5922292,-2625325,2922292,41.6179145029,18.5461897154,19.1104020429,66,0,0,
Creature,4070,3000000,327000,327000,-2673000,-2673000,41.6179145029,18.4955770811,19.1101628213,5,0,0,
Freeway,4071,3000000,295493,295493,-2704507,-2704507,41.6179145029,18.4952847039,19.1100046953,32,0,0,
Love's Abiding Joy,4072,3000000,252726,252726,-2747274,-2747274,41.6179145029,18.4948876999,19.1097900182,3,0,0,
Braindead,4073,3000000,242623,242623,-2757377,-2757377,41.6179145029,18.4947938912,19.1097392975,76,0,0,
Chain Letter,4074,3000000,205842,1022453,-2794158,-1977547,41.6179145029,18.5020090404,19.109554622,40,0,0,
Tim and Eric's Billion Dollar Movie,4075,3000000,201436,223652,-2798564,-2776348,41.6179145029,18.4946177173,19.1095324974,12,0,0,
Holly,4076,3000000,163069,163069,-2836931,-2836931,41.6179145029,18.4940549063,19.1093398181,65,0,0,
The Eclipse,4077,3000000,133411,133411,-2866589,-2866589,41.6179145029,18.4937792705,19.1091908499,66,0,0,
The Grand,4078,3000000,115879,115879,-2884121,-2884121,41.6179145029,18.4936162956,19.1091027786,19,0,0,
Sommersturm,4079,3000000,95204,95204,-2904796,-2904796,41.6179145029,18.4934240698,19.1089989086,47,0,0,
Fort McCoy,4080,3000000,78948,78948,-2921052,-2921052,41.6179145029,18.4932729036,19.1089172318,61,0,0,
The Gambler,4081,3000000,51773,101773,-2948227,-2898227,41.6179145029,18.4934851491,19.1087806786,58,0,0,
Just Looking,4082,3000000,39852,39852,-2960148,-2960148,41.6179145029,18.4929092525,19.1087207702,85,0,0,
The Divide,4083,3000000,18000,22422,-2982000,-2977578,41.6179145029,18.4927470849,19.1086109448,18,0,0,
Tanner Hall,4084,3000000,5073,5073,-2994927,-2994927,41.6179145029,18.4925856448,19.1085459696,84,0,0,
My Big Fat Independent Movie,4085,3000000,4655,4655,-2995345,-2995345,41.6179145029,18.4925817548,19.1085438685,60,0,0,
Cinderella,4103,2900000,85000000,263591415,82100000,260691415,41.2666770723,19.7320943725,19.4646302821,85,0,0,
Central do Brasil,4104,2900000,5969553,17006158,3069553,14106158,41.2666770723,18.6402691834,19.1385735796,28,0,0,
Pocketful of Miracles,4105,2900000,5000000,5000000,2100000,2100000,41.2666770723,18.5389102756,19.1338330853,62,0,0,
Boynton Beach Club,4106,2900000,3127472,3127472,227472,227472,41.2666770723,18.5221330586,19.1246135154,32,0,0,
Freakonomics,4107,2900000,101270,172867,-2798730,-2727133,41.2666770723,18.4950746874,19.1095316638,55,0,0,
Griff the Invisible,4108,2900000,20778,25935,-2879222,-2874065,41.2666770723,18.4937097779,19.1091273893,32,0,0,
Some Like it Hot,4109,2883848,25000000,25000000,22116152,22116152,41.2090963778,18.7025941648,19.2274131528,33,0,0,
High Tension,4110,2850000,3681066,6435262,831066,3585262,41.0876417139,18.5520203966,19.1275946617,82,0,0,
Young Frankenstein,4111,2800000,86300000,86300000,83500000,83500000,40.9062348924,19.0831121996,19.4695470353,72,0,0,
The Omen,4112,2800000,48570885,48570885,45770885,45770885,40.9062348924,18.8667830424,19.3277781706,68,0,0,
Hustle & Flow,4113,2800000,22201798,23590772,19401798,20790772,40.9062348924,18.6925459924,19.2152246302,14,0,0,
Friday the 13th Part VII: The New Blood,4114,2800000,19170001,19170001,16370001,16370001,40.9062348924,18.6582812324,19.2014326846,82,0,0,
Artie Lange's Beer League,4115,2800000,475000,475000,-2325000,-2325000,40.9062348924,18.4988007615,19.1119076871,78,0,0,
The Wizard of Oz,4116,2777000,33711566,33711566,30934566,30934566,40.8219710082,18.7669958658,19.2660161958,25,0,0,
Diary of the Dead,4117,2750000,952620,5394447,-1797380,2644447,40.7223819929,18.5437359816,19.1145473707,91,0,0,
The Black Stallion,4118,2700000,37799643,37799643,35099643,35099643,40.5360046442,18.7960294381,19.2837435281,83,0,0,
Ulee's Gold,4119,2700000,9054736,15600000,6354736,12900000,40.5360046442,18.6305383629,19.1544709767,43,0,0,
Lage Raho Munna Bhai,4120,2700000,2217561,31517561,-482439,28817561,40.5360046442,18.7519092779,19.121095859,89,0,0,
Donovan's Reef,4123,2686000,6600000,6600000,3914000,3914000,40.4833554873,18.5548990182,19.1426841548,50,0,0,
The Dress,4124,2650000,16556,16556,-2633444,-2633444,40.3470204552,18.49594403,19.1103613078,7,0,0,
A Guy Named Joe,4125,2627000,5363000,5363000,2736000,2736000,40.2591886466,18.5445451793,19.1369452531,4,0,0,
Blazing Saddles,4126,2600000,119500000,119500000,116900000,116900000,40.1553427287,19.2420023027,19.5802041107,77,0,0,
Friday the 13th Part IV: The Final Chapter,4127,2600000,30393007,30393007,27793007,27793007,40.1553427287,18.7445253654,19.2524341036,8,0,0,
Ida,4128,2600000,3827060,4741716,1227060,2141716,40.1553427287,18.5392808502,19.1295456563,29,0,0,
Maurice,4129,2600000,3130592,3130592,530592,530592,40.1553427287,18.5248680778,19.1261117337,17,0,0,
Riding Giants,4130,2600000,2276368,3292333,-323632,692333,40.1553427287,18.5263243946,19.1218838334,55,0,0,
Los Cronocrímenes,4131,2600000,39127,564474,-2560873,-2035526,40.1553427287,18.5014743943,19.1107253566,15,0,0,
Singin' in the Rain,4136,2540000,7200000,7200000,4660000,4660000,39.9216450694,18.5614008533,19.1463015087,70,0,0,
A Haunted House,4137,2500000,40041683,59922558,37541683,57422558,39.7635364384,18.9387171078,19.2939930078,32,0,0,
2016: Obamas America,4138,2500000,33349941,33349941,30849941,30849941,39.7635364384,18.7663971428,19.2656527388,19,0,0,
Kevin Hart: Let Me Explain,4139,2500000,32244051,32327255,29744051,29827255,39.7635364384,18.7591331403,19.2608908541,50,0,0,
Garden State,4140,2500000,26782316,36028802,24282316,33528802,39.7635364384,18.7851783192,19.2370346123,54,0,0,
That Thing You Do!,4141,2500000,25809813,34509813,23309813,32009813,39.7635364384,18.7745722027,19.2327264889,90,0,0,
Halloween II,4142,2500000,25533818,25533818,23033818,23033818,39.7635364384,18.709492628,19.2315004608,6,0,0,
Halloween 3: Season of the Witch,4143,2500000,14400000,14400000,11900000,11900000,39.7635364384,18.6223983259,19.1807448073,87,0,0,
Religulous,4144,2500000,13011160,13881317,10511160,11381317,39.7635364384,18.6181499849,19.1742289025,55,0,0,
Escape from the Planet of the Apes,4145,2500000,12300000,12300000,9800000,9800000,39.7635364384,18.6050854795,19.1708759037,25,0,0,
Hud,4146,2500000,10000000,10000000,7500000,7500000,39.7635364384,18.5857734156,19.1599541674,42,0,0,
The Spectacular Now,4147,2500000,6852971,6916951,4352971,4416951,39.7635364384,18.5592871756,19.1448143093,20,0,0,
My Own Private Idaho,4148,2500000,6401336,6401336,3901336,3901336,39.7635364384,18.5547882782,19.142622634,46,0,0,
Before Sunrise,4149,2500000,5184616,5184616,2684616,2684616,39.7635364384,18.5440910988,19.1366941728,70,0,0,
Robot & Frank,4150,2500000,3317468,4934356,817468,2434356,39.7635364384,18.5418765983,19.127527599,28,0,0,
Sur Le Seuil,4151,2500000,2013052,2013052,-486948,-486948,39.7635364384,18.5156571773,19.121073477,80,0,0,
Jesus' Son,4152,2500000,1282084,1687548,-1217916,-812452,39.7635364384,18.5126926724,19.1174384239,51,0,0,
Saving Face,4153,2500000,1187266,1269705,-1312734,-1230295,39.7635364384,18.5088742695,19.1169659309,72,0,0,
Brick Lane,4154,2500000,1094998,3838486,-1405002,1338486,39.7635364384,18.5321212908,19.1165059305,96,0,0,
The Lost Medallion: The Adventures of Billy Stone,4155,2500000,549632,549632,-1950368,-1950368,39.7635364384,18.5022595697,19.1137826885,13,0,0,
My Life Without Me,4156,2500000,432360,12267275,-2067640,9767275,39.7635364384,18.6048133016,19.11319613,38,0,0,
Marilyn Hotchkiss' Ballroom Dancing and Charm School,4157,2500000,341897,489960,-2158103,-2010040,39.7635364384,18.5017094455,19.1127434267,59,0,0,
Super,4158,2500000,324138,590355,-2175862,-1909645,39.7635364384,18.502634827,19.1126545314,59,0,0,
Fuel,4159,2500000,174255,174255,-2325745,-2325745,39.7635364384,18.4987938713,19.1119039549,0,0,0,
Valley of the Hearts Delight,4160,2500000,118666,118666,-2381334,-2381334,39.7635364384,18.4982796188,19.1116254359,79,0,0,
The Other End of the Line,4161,2500000,115504,507446,-2384496,-1992554,39.7635364384,18.5018706826,19.1116095909,5,0,0,
8: The Mormon Proposition,4162,2500000,100280,100280,-2399720,-2399720,39.7635364384,18.4981094721,19.1115332989,77,0,0,
Sleep Dealer,4163,2500000,80136,108907,-2419864,-2391093,39.7635364384,18.4981893112,19.1114323424,64,0,0,
Eye of the Dolphin,4164,2500000,72210,72260,-2427790,-2427740,39.7635364384,18.4978501153,19.1113926166,17,0,0,
Underdogs,4165,2500000,35017,35017,-2464983,-2464983,39.7635364384,18.4975052851,19.1112061808,5,0,0,
Anatomie,4166,2500000,9598,9598,-2490402,-2490402,39.7635364384,18.4972698642,19.111078744,60,0,0,
Go For It!,4175,2450000,180237,182358,-2269763,-2267642,39.5632099841,18.4993310982,19.1121843647,84,0,0,
Get on the Bus,4176,2400000,5660056,5660056,3260056,3260056,39.3597934253,18.5491645264,19.1395023818,20,0,0,
Thr3e,4177,2400000,1008849,1420418,-1391151,-979582,39.3597934253,18.5111671262,19.1165749979,62,0,0,
Idiocracy,4178,2400000,444093,500296,-1955907,-1899704,39.3597934253,18.5027264106,19.1137549919,90,0,0,
This is England,4180,2380000,327919,8739576,-2052081,6359576,39.2775363542,18.5760576831,19.1132739712,13,0,0,
Bathing Beauty,4181,2361000,3500000,3500000,1139000,1139000,39.1989105382,18.5303352055,19.1291121287,78,0,0,
Do You Believe?,4182,2300000,12985600,13741342,10685600,11441342,38.9432290496,18.618642552,19.1750496434,97,0,0,
Show Boat,4183,2300000,11000000,11000000,8700000,8700000,38.9432290496,18.5958957926,19.1656673445,50,0,0,
"Dancer, Texas Pop. 81",4184,2300000,565592,565592,-1734408,-1734408,38.9432290496,18.5042480085,19.1148619548,82,0,0,
Redemption Road,4185,2300000,29384,29384,-2270616,-2270616,38.9432290496,18.4993036073,19.1121800926,3,0,0,
Fantasia,4189,2280000,83320000,83320000,81040000,81040000,38.8582923847,19.0703474097,19.4608914499,5,0,0,
Friday the 13th Part 3,4190,2250000,33985198,33985198,31735198,31735198,38.7298334621,18.7726426792,19.2694483195,41,0,0,
The French Connection,4191,2200000,41158757,41158757,38958757,38958757,38.5128510684,18.8221980632,19.2998927914,67,0,0,
Friday the 13th Part V: A New Beginning,4192,2200000,20674880,20674880,18474880,18474880,38.5128510684,18.6747423443,19.2110281398,65,0,0,
The Last Sin Eater,4193,2200000,388390,388390,-1811610,-1811610,38.5128510684,18.5035376297,19.1144762693,4,0,0,
The Valley of Decision,4195,2160000,9132000,9132000,6972000,6972000,38.3365862548,18.5812869024,19.1574299919,76,0,0,
The Best Years of Our Lives,4198,2100000,23600000,23600000,21500000,21500000,38.0675409584,18.697935455,19.2246593917,2,0,0,
Bully,4199,2100000,881824,1381824,-1218176,-718176,38.0675409584,18.5135521889,19.1174371285,88,0,0,
Elling,4200,2100000,313436,313436,-1786564,-1786564,38.0675409584,18.5037681473,19.1146014103,96,0,0,
Courageous,4207,2000000,34522221,35185884,32522221,33185884,37.6060309309,18.7827937568,19.2728106626,26,0,0,
Nancy Drew,4208,2000000,25584685,30703845,23584685,28703845,37.6060309309,18.7510924168,19.2339460362,49,0,0,
From Russia With Love,4209,2000000,24800000,78900000,22800000,76900000,37.6060309309,19.048490375,19.2304606144,58,0,0,
Mad Max 2: The Road Warrior,4210,2000000,24600832,24600832,22600832,22600832,37.6060309309,18.7062436276,19.2295740115,64,0,0,
Notorious,4211,2000000,24464742,24464742,22464742,22464742,37.6060309309,18.7052202638,19.22896775,55,0,0,
In the Heat of the Night,4212,2000000,24379978,24379978,22379978,22379978,37.6060309309,18.7045823294,19.2285899527,60,0,0,
Sleeper,4213,2000000,18344729,18344729,16344729,16344729,37.6060309309,18.6580819384,19.2013169166,93,0,0,
Everything You Always Wanted to Know,4214,2000000,18016290,18016290,16016290,16016290,37.6060309309,18.655488262,19.1998111569,51,0,0,
It Follows,4215,2000000,14674077,20649774,12674077,18649774,37.6060309309,18.6760979798,19.1843581377,53,0,0,
To Kill A Mockingbird,4216,2000000,13129846,13129846,11129846,11129846,37.6060309309,18.6160837642,19.1771367853,37,0,0,
Silent House,4217,2000000,12739737,16610760,10739737,14610760,37.6060309309,18.6443121923,19.1753042212,22,0,0,
The Legend of Drunken Master,4218,2000000,11546543,11546543,9546543,9546543,37.6060309309,18.6029755088,19.1696781742,37,0,0,
Boys Don't Cry,4219,2000000,11540607,20741000,9540607,18741000,37.6060309309,18.6768043607,19.169650106,26,0,0,
Das Leben der Anderen,4220,2000000,11284657,81197047,9284657,79197047,37.6060309309,19.0606765313,19.1684391042,27,0,0,
Lolita,4221,2000000,9250000,9250000,7250000,7250000,37.6060309309,18.5836516284,19.1587598027,50,0,0,
Boom Town,4222,2000000,9172000,9172000,7172000,7172000,37.6060309309,18.5829887083,19.1583868688,8,0,0,
Gentleman's Agreement,4223,2000000,7800000,7800000,5800000,5800000,37.6060309309,18.5712556842,19.1518042147,76,0,0,
The Hustler,4224,2000000,7600000,7600000,5600000,5600000,37.6060309309,18.5695337761,19.1508410152,22,0,0,
Witchboard,4225,2000000,7369373,7369373,5369373,5369373,37.6060309309,18.5675444957,19.1497291632,3,0,0,
Les Triplettes de Belleville,4226,2000000,6998643,17100523,4998643,15100523,37.6060309309,18.6482207368,19.1479392802,49,0,0,
Smoke Signals,4227,2000000,6719300,7756617,4719300,5756617,37.6060309309,18.5708824283,19.1465884937,22,0,0,
Winter's Bone,4228,2000000,6531503,16131551,4531503,14131551,37.6060309309,18.6404730301,19.1456793588,53,0,0,
American Splendor,4229,2000000,6003587,8685632,4003587,6685632,37.6060309309,18.5788451353,19.1431192541,68,0,0,
Before Sunset,4230,2000000,5792822,11293790,3792822,9293790,37.6060309309,18.6008669559,19.1420953253,22,0,0,
Amores Perros,4231,2000000,5383834,20883834,3383834,18883834,37.6060309309,18.6779093512,19.1401054025,30,0,0,
Thirteen,4232,2000000,4601043,9505996,2601043,7505996,37.6060309309,18.5858242493,19.136285671,86,0,0,
Touching the Void,4233,2000000,4593598,15396525,2593598,13396525,37.6060309309,18.6345556095,19.136249272,25,0,0,
Inside Job,4234,2000000,4311834,7799257,2311834,5799257,37.6060309309,18.5712492928,19.1348707384,24,0,0,
Alexander's Ragtime Band,4235,2000000,4000000,4000000,2000000,2000000,37.6060309309,18.5380213885,19.1333428683,1,0,0,
Me and You and Everyone We Know,4236,2000000,3885134,9615464,1885134,7615464,37.6060309309,18.5867518581,19.132779479,64,0,0,
We Are Your Friends,4237,2000000,3591417,9417474,1591417,7417474,37.6060309309,18.5850735028,19.1313374246,71,0,0,
Harsh Times,4238,2000000,3337931,6225304,1337931,4225304,37.6060309309,18.5576173598,19.1300912174,87,0,0,
Ghost Dog: Way of the Samurai,4239,2000000,3330230,6030230,1330230,4030230,37.6060309309,18.5559148163,19.1300533328,31,0,0,
Captive,4240,2000000,2583301,2757776,583301,757776,37.6060309309,18.5269130416,19.1263720273,74,0,0,
Full Frontal,4241,2000000,2512846,3438804,512846,1438804,37.6060309309,18.5330182776,19.1260240831,15,0,0,
Waltz with Bashir,4242,2000000,2283849,13912289,283849,11912289,37.6060309309,18.622498762,19.1248923376,93,0,0,
Strangers with Candy,4243,2000000,2072645,2077844,72645,77844,37.6060309309,18.5207802187,19.1238473916,2,0,0,
Shortbus,4244,2000000,1985292,1985292,-14708,-14708,37.6060309309,18.5199425061,19.1234148874,50,0,0,
Son of Rambow: A Home Movie,4245,2000000,1785505,11263263,-214495,9263263,37.6060309309,18.600611988,19.1224249936,17,0,0,
"The Book of Mormon Movie, Volume 1: The Journey",4246,2000000,1660865,1660865,-339135,-339135,37.6060309309,18.5170004777,19.1218069374,43,0,0,
Hamlet,4247,2000000,1577287,2419669,-422713,419669,37.6060309309,18.5238680991,19.1213922825,22,0,0,
No End In Sight,4248,2000000,1433319,1433319,-566681,-566681,37.6060309309,18.5149318268,19.1206776118,30,0,0,
Get Real,4249,2000000,1152411,1152411,-847589,-847589,37.6060309309,18.5123721385,19.1192816857,63,0,0,
In the Shadow of the Moon,4250,2000000,1134358,1134358,-865642,-865642,37.6060309309,18.5122074117,19.1191919076,61,0,0,
Meek's Cutoff,4251,2000000,977772,1869928,-1022228,-130072,37.6060309309,18.5188973325,19.1184128627,41,0,0,
Inside Deep Throat,4252,2000000,653621,653621,-1346379,-1346379,37.6060309309,18.5078108582,19.1167982189,87,0,0,
The Virginity Hit,4253,2000000,636706,636706,-1363294,-1363294,37.6060309309,18.5076558104,19.1167138912,58,0,0,
Dinner Rush,4254,2000000,615941,1053218,-1384059,-946782,37.6060309309,18.511466705,19.11661036,48,0,0,
Clockwatchers,4255,2000000,537948,539961,-1462052,-1460039,37.6060309309,18.5067685555,19.1162214029,71,0,0,
Subway,4256,2000000,390659,1663296,-1609341,-336704,37.6060309309,18.5170225552,19.1154864485,90,0,0,
House of D,4257,2000000,388532,466106,-1611468,-1533894,37.6060309309,18.5060906961,19.115475831,70,0,0,
Teeth,4258,2000000,347578,2350641,-1652422,350641,37.6060309309,18.5232453017,19.1152713773,50,0,0,
Stonewall,4259,2000000,304602,304602,-1695398,-1695398,37.6060309309,18.5046067696,19.1150567842,56,0,0,
Sherrybaby,4260,2000000,199176,622806,-1800824,-1377194,37.6060309309,18.507528381,19.1145301629,28,0,0,
Six-String Samurai,4261,2000000,124494,124494,-1875506,-1875506,37.6060309309,18.502949305,19.1141569454,69,0,0,
Hum to Mohabbt Karega,4262,2000000,121807,121807,-1878193,-1878193,37.6060309309,18.5029245567,19.1141435148,66,0,0,
It's All Gone Pete Tong,4263,2000000,120620,2226603,-1879380,226603,37.6060309309,18.522125207,19.1141375816,18,0,0,
Saint John of Las Vegas,4264,2000000,102645,102645,-1897355,-1897355,37.6060309309,18.5027480501,19.1140477304,4,0,0,
24 7: Twenty Four Seven,4265,2000000,72544,72544,-1927456,-1927456,37.6060309309,18.5024707182,19.1138972472,7,0,0,
Pump,4266,2000000,72277,72277,-1927723,-1927723,37.6060309309,18.5024682579,19.1138959123,77,0,0,
Roadside Romeo,4267,2000000,55202,2046090,-1944798,46090,37.6060309309,18.5204928839,19.1138105394,30,0,0,
Eureka,4268,2000000,49388,76654,-1950612,-1923346,37.6060309309,18.5025085897,19.1137814685,61,0,0,
This Thing of Ours,4269,2000000,37227,37227,-1962773,-1962773,37.6060309309,18.5021452313,19.1137206588,95,0,0,
Super Capers,4270,2000000,30955,30955,-1969045,-1969045,37.6060309309,18.5020874165,19.113689295,89,0,0,
Return of the Living Dead 3,4271,2000000,21000,21000,-1979000,-1979000,37.6060309309,18.5019956452,19.1136395118,67,0,0,
The Missing Person,4272,2000000,17896,17896,-1982104,-1982104,37.6060309309,18.5019670289,19.1136239888,77,0,0,
London,4273,2000000,12667,12667,-1987333,-1987333,37.6060309309,18.5019188201,19.1135978381,24,0,0,
Circle,4274,2000000,10024,10024,-1989976,-1989976,37.6060309309,18.501894452,19.11358462,10,0,0,
Eden Lake,4275,2000000,7321,4294373,-1992679,2294373,37.6060309309,18.5406357748,19.1135711016,91,0,0,
Jerusalema,4276,2000000,7294,10679,-1992706,-1989321,37.6060309309,18.501900491,19.1135709666,49,0,0,
Say Uncle,4277,2000000,5361,5361,-1994639,-1994639,37.6060309309,18.5018514584,19.113561299,68,0,0,
Plush,4278,2000000,3320,29104,-1996680,-1970896,37.6060309309,18.5020703535,19.1135510912,73,0,0,
The Ghastly Love of Johnny X,4279,2000000,2436,2436,-1997564,-1997564,37.6060309309,18.5018244884,19.11354667,94,0,0,
Buried,4306,1987650,1044143,21270290,-943507,19282640,37.5478417023,18.6809881407,19.1188045904,31,0,0,
River's Edge,4308,1900000,4600000,4600000,2700000,2700000,37.1268753763,18.5442270689,19.1367693511,15,0,0,
Man on Wire,4309,1900000,2962242,5617067,1062242,3717067,37.1268753763,18.5531755533,19.1287340886,1,0,0,
Nowhere Boy,4310,1900000,1445366,7785229,-454634,5885229,37.1268753763,18.5719885668,19.1212338677,8,0,0,
Northfork,4311,1900000,1420578,1445140,-479422,-454860,37.1268753763,18.5159489411,19.1211108347,9,0,0,
Brotherly Love,4312,1900000,478595,478595,-1421405,-1421405,37.1268753763,18.5071229649,19.1164241315,8,0,0,
Submarine,4313,1900000,467602,4581937,-1432398,2681937,37.1268753763,18.5440674188,19.1163693075,64,0,0,
The Square,4314,1900000,406216,740932,-1493784,-1159068,37.1268753763,18.5095261997,19.1160631097,97,0,0,
ABCD (Any Body Can Dance),4315,1900000,222098,10137234,-1677902,8237234,37.1268753763,18.5920043444,19.115144153,86,0,0,
Chacun sa nuit,4316,1900000,18435,139317,-1881565,-1760683,37.1268753763,18.5040062942,19.1141266599,91,0,0,
The Last Exorcism,4319,1800000,41034350,70165900,39234350,68365900,36.6284150148,19.0018686963,19.3010361513,14,0,0,
Carrie,4320,1800000,25878153,25878153,24078153,24078153,36.6284150148,18.71728585,19.2361317217,19,0,0,
A Nightmare on Elm Street,4321,1800000,25504513,25504513,23704513,23704513,36.6284150148,18.7145045797,19.2344772219,10,0,0,
Beasts of the Southern Wild,4322,1800000,12795746,21911774,10995746,20111774,36.6284150148,18.6873588903,19.17650722,55,0,0,
Dr. Strangelove,4323,1800000,9164370,9164370,7364370,7364370,36.6284150148,18.5846228623,19.1593063777,88,0,0,
Battle for the Planet of the Apes,4324,1800000,8800000,8800000,7000000,7000000,36.6284150148,18.5815253296,19.1575640098,51,0,0,
A Streetcar Named Desire,4325,1800000,8000000,8000000,6200000,6200000,36.6284150148,18.5746906311,19.1537278349,45,0,0,
Hang 'em High,4326,1800000,6800000,6800000,5000000,5000000,36.6284150148,18.56435019,19.1479458377,0,0,0,
El crimen de padre Amaro,4327,1800000,5719000,5719000,3919000,3919000,36.6284150148,18.5549427372,19.1427084434,4,0,0,
Songcatcher,4328,1800000,3050934,3050934,1250934,1250934,36.6284150148,18.5313377923,19.1296631578,84,0,0,
Higher Ground,4329,1800000,841056,842693,-958944,-957307,36.6284150148,18.5113705847,19.1187277856,71,0,0,
POM Wonderful Presents: The Greatest Movie Ever Sold,4330,1800000,638476,638476,-1161524,-1161524,36.6284150148,18.5095037274,19.1177193282,96,0,0,
Travellers and Magicians,4331,1800000,506793,1322161,-1293207,-477839,36.6284150148,18.5157400106,19.1170632552,72,0,0,
Ed and his Dead Mother,4332,1800000,673,673,-1799327,-1799327,36.6284150148,18.5036506863,19.1145376427,13,0,0,
Lola rennt,4339,1750000,7267324,22879194,5517324,21129194,36.3713576256,18.6951213033,19.1504425766,3,0,0,
May,4340,1750000,145540,634803,-1604460,-1115197,36.3713576256,18.5099275331,19.1155108127,67,0,0,
I Spit on Your Grave,4341,1750000,93051,1278471,-1656949,-471529,36.3713576256,18.5157973869,19.1152487747,62,0,0,
In the Bedroom,4343,1700000,35930604,42137871,34230604,40437871,36.1087313685,18.8320491467,19.2800705936,11,0,0,
La misma luna,4344,1700000,12590147,23271741,10890147,21571741,36.1087313685,18.6984790046,19.1760111805,32,0,0,
Conquest of the Planet of the Apes,4345,1700000,9700000,9700000,8000000,8000000,36.1087313685,18.5900035317,19.1623386259,12,0,0,
The Lunchbox,4346,1700000,4231500,12231500,2531500,10531500,36.1087313685,18.6111501997,19.13594562,51,0,0,
Grace Unplugged,4347,1700000,2507159,2507159,807159,807159,36.1087313685,18.5273570027,19.1274767541,23,0,0,
"Happy, Texas",4348,1700000,1943649,2795685,243649,1095685,36.1087313685,18.5299469655,19.1246935295,50,0,0,
My Summer of Love,4349,1700000,1000915,4727375,-699085,3027375,36.1087313685,18.5471161685,19.1200198947,90,0,0,
Yes,4350,1700000,396035,661221,-1303965,-1038779,36.1087313685,18.5106262232,19.1170096375,70,0,0,
From Here to Eternity,4351,1650000,30500000,30500000,28850000,28850000,35.8402463422,18.7521421761,19.2570244879,17,0,0,
You Can't Take It With You,4352,1644000,4000000,4000000,2356000,2356000,35.8076197755,18.5411822325,19.1350869467,72,0,0,
Foolish,4353,1600000,6026908,6026908,4426908,4426908,35.5655882008,18.5593738545,19.1451726505,72,0,0,
She Wore a Yellow Ribbon,4354,1600000,5400000,5400000,3800000,3800000,35.5655882008,18.553901706,19.1421302144,68,0,0,
The Conversation,4355,1600000,4420000,4420000,2820000,2820000,35.5655882008,18.5452870438,19.137355571,68,0,0,
N-Secure,4356,1600000,2595644,2595644,995644,995644,35.5655882008,18.5290497038,19.1284059716,66,0,0,
Sukkar banat,4357,1600000,1060591,14253760,-539409,12653760,35.5655882008,18.6285401009,19.1208130318,3,0,0,
Out of the Dark,4358,1600000,419428,419428,-1180572,-1180572,35.5655882008,18.5093294216,19.1176244536,11,0,0,
Bubble,4359,1600000,145382,145382,-1454618,-1454618,35.5655882008,18.5068182927,19.1162584834,10,0,0,
Dil Jo Bhi Kahey...,4360,1600000,129319,129319,-1470681,-1470681,35.5655882008,18.5066709089,19.1161783601,17,0,0,
Mississippi Mermaid,4361,1600000,27795,2627795,-1572205,1027795,35.5655882008,18.529338152,19.1156718036,17,0,0,
I Love Your Work,4362,1600000,3264,3264,-1596736,-1596736,35.5655882008,18.5055135547,19.115549367,42,0,0,
Insidious,4363,1500000,54009150,99870886,52509150,98370886,34.9963551158,19.1569885966,19.3546167621,13,0,0,
Cabin Fever,4364,1500000,21158188,30351664,19658188,28851664,34.9963551158,18.7521541214,19.2163822972,57,0,0,
Waitress,4365,1500000,19067631,22187264,17567631,20687264,34.9963551158,18.6917569949,19.2069035733,71,0,0,
Kickboxer,4366,1500000,14533681,14533681,13033681,13033681,34.9963551158,18.6316215275,19.1860323096,38,0,0,
Bloodsport,4367,1500000,11806119,11806119,10306119,10306119,34.9963551158,18.6092855283,19.1732633219,47,0,0,
Mr. Smith Goes To Washington,4368,1500000,9000000,9000000,7500000,7500000,34.9963551158,18.5857734156,19.1599541674,41,0,0,
The Squid and the Whale,4369,1500000,7372734,11191423,5872734,9691423,34.9963551158,18.6041821462,19.1521542715,0,0,0,
Kids,4370,1500000,7269578,20269578,5769578,18769578,34.9963551158,18.6770255432,19.1516577622,2,0,0,
Kissing Jessica Stein,4371,1500000,7025722,9345061,5525722,7845061,34.9963551158,18.5886946241,19.1504830562,28,0,0,
Spellbound,4372,1500000,7000000,7000000,5500000,5500000,34.9963551158,18.5686717089,19.1503590673,25,0,0,
Dawn of the Dead,4373,1500000,5100000,55000000,3600000,53500000,34.9963551158,18.9150735374,19.1411576472,82,0,0,
Exotica,4374,1500000,5046118,5046118,3546118,3546118,34.9963551158,18.5516770761,19.140895466,71,0,0,
The To Do List,4375,1500000,3491669,4128828,1991669,2628828,34.9963551158,18.5435978666,19.1333020175,37,0,0,
The Gatekeepers,4376,1500000,2408553,2592308,908553,1092308,34.9963551158,18.5299166905,19.1279767265,74,0,0,
Repo Man,4377,1500000,2300000,2300000,800000,800000,34.9963551158,18.5272926544,19.1274414437,94,0,0,
Buffalo '66,4378,1500000,2180752,2180752,680752,680752,34.9963551158,18.5262201897,19.1268530926,45,0,0,
Blood Simple,4379,1500000,1690913,2730877,190913,1230877,34.9963551158,18.5311582167,19.124432665,22,0,0,
Nueve Reinas,4380,1500000,1222889,12412889,-277111,10912889,34.9963551158,18.614297692,19.1221145455,78,0,0,
The Lords of Salem,4381,1500000,1165881,1165881,-334119,-334119,34.9963551158,18.5170460307,19.1218318178,4,0,0,
The Ballad of Jack and Rose,4382,1500000,712294,1126258,-787706,-373742,34.9963551158,18.5166861367,19.1195794279,71,0,0,
Killing Zoe,4383,1500000,418953,418953,-1081047,-1081047,34.9963551158,18.510239827,19.1181200701,97,0,0,
The Believer,4384,1500000,406035,406035,-1093965,-1093965,34.9963551158,18.5101217064,19.1180557547,71,0,0,
Snow Angels,4385,1500000,402858,414404,-1097142,-1085596,34.9963551158,18.5101982331,19.1180399366,67,0,0,
Session 9,4386,1500000,378176,1619602,-1121824,119602,34.9963551158,18.5211579517,19.1179170377,86,0,0,
MOOZ-lum,4387,1500000,362239,372239,-1137761,-1127761,34.9963551158,18.5098126137,19.1178376748,60,0,0,
I Want Someone To Eat Cheese With,4388,1500000,194568,194568,-1305432,-1305432,34.9963551158,18.5081860907,19.1170023258,96,0,0,
Amigo,4389,1500000,184705,184705,-1315295,-1315295,34.9963551158,18.5080957204,19.1169531659,89,0,0,
Hatchet,4390,1500000,175281,240396,-1324719,-1259604,34.9963551158,18.5086058851,19.1169061918,32,0,0,
My Name is Bruce,4391,1500000,173066,173066,-1326934,-1326934,34.9963551158,18.5079890669,19.1168951508,64,0,0,
Modern Times,4392,1500000,163245,163245,-1336755,-1336755,34.9963551158,18.5078990638,19.116846195,25,0,0,
The Salon,4393,1500000,139084,139084,-1360916,-1360916,34.9963551158,18.5076776093,19.1167257468,17,0,0,
Stolen Summer,4394,1500000,119841,119841,-1380159,-1380159,34.9963551158,18.507501197,19.1166298056,87,0,0,
Road Hard,4395,1500000,113169,113169,-1386831,-1386831,34.9963551158,18.5074400234,19.1165965384,100,0,0,
Forty Shades of Blue,4396,1500000,75828,172569,-1424172,-1327431,34.9963551158,18.5079845124,19.1164103323,20,0,0,
Trucker,4397,1500000,52429,52429,-1447571,-1447571,34.9963551158,18.5068829446,19.1162936322,93,0,0,
Pontypool,4398,1500000,3865,31916,-1496135,-1468084,34.9963551158,18.5066947388,19.1160513809,9,0,0,
"Me, You and Five Bucks",4399,1500000,2105,2105,-1497895,-1497895,34.9963551158,18.5064211612,19.1160426004,1,0,0,
Snow White and the Seven Dwarfs,4411,1488000,184925485,184925485,183437485,183437485,34.9261514421,19.4987083714,19.7697373202,47,0,0,
Shalako,4412,1455000,2620000,2620000,1165000,1165000,34.7308768703,18.5305681757,19.1292401487,74,0,0,
Holy Girl,4413,1400000,304124,1261792,-1095876,-138208,34.3979062825,18.5188235808,19.1180462399,52,0,0,
La chambre bleue,4414,1400000,260441,1945420,-1139559,545420,34.3979062825,18.5250016775,19.1178287207,85,0,0,
Incident at Loch Ness,4415,1400000,36830,56073,-1363170,-1343927,34.3979062825,18.5078333319,19.1167145094,15,0,0,
Eddie: The Sleepwalking Cannibal,4416,1400000,1632,1632,-1398368,-1398368,34.3979062825,18.5073342353,19.1165390112,19,0,0,
"Lock, Stock and Two Smoking Barrels",4421,1350000,3714067,28172686,2364067,26822686,34.086580994,18.7374816773,19.1351264325,44,0,0,
The Ballad of Gregorio Cortez,4422,1305000,909000,909000,-396000,-396000,33.798904803,18.5164839114,19.1215248322,52,0,0,
San Francisco,4423,1300000,2868000,5273000,1568000,3973000,33.7664837539,18.5554147807,19.1312223653,46,0,0,
Festen,4424,1300000,1647780,1647780,347780,347780,33.7664837539,18.5232194802,19.1252084253,37,0,0,
Trees Lounge,4425,1300000,749741,749741,-550259,-550259,33.7664837539,18.5150812648,19.120759158,22,0,0,
The Girlfriend Experience,4426,1300000,695840,1005840,-604160,-294160,33.7664837539,18.5174088454,19.1204914787,8,0,0,
Journey from the Fall,4427,1300000,635305,635305,-664695,-664695,33.7664837539,18.5140394482,19.1201907687,18,0,0,
The Basket,4428,1300000,609042,609042,-690958,-690958,33.7664837539,18.5138001987,19.120060278,48,0,0,
Above and Beyond,4429,1300000,288751,288751,-1011249,-1011249,33.7664837539,18.5108778105,19.118467505,9,0,0,
Def-Con 4,4430,1300000,210904,210904,-1089096,-1089096,33.7664837539,18.5101662296,19.1180799967,79,0,0,
Neal n' Nikki,4431,1300000,100358,329621,-1199642,-970379,33.7664837539,18.5112511909,19.1175294604,40,0,0,
The Hebrew Hammer,4432,1300000,77755,90213,-1222245,-1209787,33.7664837539,18.5090620198,19.1174168566,47,0,0,
Los insolitos peces gato,4433,1300000,11278,11278,-1288722,-1288722,33.7664837539,18.5083391783,19.1170856075,51,0,0,
Simon,4434,1300000,3771,1738379,-1296229,438379,33.7664837539,18.5240368412,19.1170481939,87,0,0,
Rebecca,4438,1288000,6000000,6000000,4712000,4712000,33.6882899051,18.5618524922,19.1465531695,32,0,0,
Friday the 13th Part 2,4439,1250000,21722776,21722776,20472776,20472776,33.4370152488,18.6901200597,19.2200515042,73,0,0,
The Lost Weekend,4440,1250000,11000000,11000000,9750000,9750000,33.4370152488,18.6046695935,19.1706397386,40,0,0,
C.H.U.D.,4441,1250000,4700000,4700000,3450000,3450000,33.4370152488,18.5508335532,19.1404276005,42,0,0,
Filly Brown,4442,1250000,2850357,2850357,1600357,1600357,33.4370152488,18.5344611041,19.1313813478,95,0,0,
Niagara,4443,1250000,2500000,2500000,1250000,1250000,33.4370152488,18.5313294306,19.1296585612,25,0,0,
The Rocky Horror Picture Show,4446,1200000,140241017,140241017,139041017,139041017,33.0975091965,19.3349344385,19.6473412392,22,0,0,
Saw,4447,1200000,55968727,103880027,54768727,102680027,33.0975091965,19.1774141283,19.3634577881,79,0,0,
"Sex, Lies, and Videotape",4448,1200000,23676707,35676707,22476707,34476707,33.0975091965,18.7917403735,19.2290210671,84,0,0,
Super Troopers,4449,1200000,18492362,23046142,17292362,21846142,33.0975091965,18.700555297,19.2056487646,67,0,0,
Monsoon Wedding,4450,1200000,13876974,27025600,12676974,25825600,33.0975091965,18.7301916397,19.1843716362,6,0,0,
You Can Count on Me,4451,1200000,9180275,10827356,7980275,9627356,33.0975091965,18.6036487418,19.1622446666,76,0,0,
Strangers on a Train,4452,1200000,7000000,7000000,5800000,5800000,33.0975091965,18.5712556842,19.1518042147,52,0,0,
The Trouble With Harry,4453,1200000,7000000,7000000,5800000,5800000,33.0975091965,18.5712556842,19.1518042147,24,0,0,
"Il buono, il brutto, il cattivo",4454,1200000,6100000,6100000,4900000,4900000,33.0975091965,18.5634836406,19.1474624921,75,0,0,
The Day the Earth Stood Still,4455,1200000,3700000,3700000,2500000,2500000,33.0975091965,18.5424579435,19.1357915534,37,0,0,
Home Run,4456,1200000,2859955,2859955,1659955,1659955,33.0975091965,18.5349928474,19.1316741099,95,0,0,
Reservoir Dogs,4457,1200000,2832029,2832029,1632029,1632029,33.0975091965,18.5347437222,19.1315369402,11,0,0,
But I'm a Cheerleader,4458,1200000,2205627,2509344,1005627,1309344,33.0975091965,18.5318605686,19.128455163,77,0,0,
The Wrong Man,4459,1200000,2000000,2000000,800000,800000,33.0975091965,18.5272926544,19.1274414437,13,0,0,
The Blue Bird,4460,1200000,887000,887000,-313000,-313000,33.0975091965,18.5172378007,19.1219365655,81,0,0,
Blue Like Jazz,4461,1200000,595018,595018,-604982,-604982,33.0975091965,18.5145832062,19.120487396,62,0,0,
Que Horas Ela Volta?,4462,1200000,372508,3003079,-827492,1803079,33.0975091965,18.53626867,19.1193816192,6,0,0,
Q,4463,1200000,255000,255000,-945000,-945000,33.0975091965,18.5114829783,19.1187971624,85,0,0,
Down & Out with the Dolls,4464,1200000,58936,58936,-1141064,-1141064,33.0975091965,18.5096909204,19.1178212257,13,0,0,
"Pink Ribbons, Inc.",4465,1200000,26608,26608,-1173392,-1173392,33.0975091965,18.5093951284,19.1176602169,80,0,0,
Certifiably Jonathan,4466,1200000,7826,7826,-1192174,-1192174,33.0975091965,18.5092232383,19.1175666618,69,0,0,
La navaja de Don Juan,4467,1200000,4254,4254,-1195746,-1195746,33.0975091965,18.5091905445,19.1175488683,26,0,0,
Gods Not Dead,4477,1150000,60755732,63777092,59605732,62627092,32.7472217062,18.96924907,19.3821247603,34,0,0,
Waiting...,4478,1125000,16124543,18673274,14999543,17548274,32.5677781216,18.6675292281,19.1951353583,7,0,0,
Dead Man's Shoes,4479,1125000,6013,414341,-1118987,-710659,32.5677781216,18.5136206898,19.1179311647,59,0,0,
Wolf Creek,4480,1100000,16186348,29005064,15086348,27905064,32.3853184046,18.7453356155,19.1955354103,48,0,0,
Serbuan maut,4481,1100000,4105123,9297407,3005123,8197407,32.3853184046,18.5916687262,19.1382592542,94,0,0,
The Offspring,4482,1100000,1355728,1355728,255728,255728,32.3853184046,18.5223883259,19.12475327,74,0,0,
Sex with Strangers,4483,1100000,247740,247740,-852260,-852260,32.3853184046,18.51232952,19.1192584575,50,0,0,
Beyond the Black Rainbow,4484,1100000,56491,56491,-1043509,-1043509,32.3853184046,18.5105829909,19.1183069388,66,0,0,
Dracula: Pages from a Virgin's Diary,4485,1100000,39659,81371,-1060341,-1018629,32.3853184046,18.5108103734,19.1182231514,89,0,0,
The Sleepwalker,4486,1100000,2636,2636,-1097364,-1097364,32.3853184046,18.510090624,19.1180388312,24,0,0,
Rocket Singh: Salesman of the Year,4492,1070000,164649,5348767,-905351,4278767,32.162214527,18.5580834622,19.1189944053,80,0,0,
Casablanca,4493,1039000,10462500,10462500,9423500,9423500,31.9266893753,18.6019495969,19.169096208,9,0,0,
Rocky,4494,1000000,117235147,225000000,116235147,224000000,31.6227766017,19.6279986731,19.5781167177,92,0,0,
The Devil Inside,4495,1000000,53261944,101758489,52261944,100758489,31.6227766017,19.168357449,19.3536447609,36,0,0,
Tom Jones,4496,1000000,37600000,37600000,36600000,36600000,31.6227766017,18.8062848687,19.290053107,63,0,0,
Unfriended,4497,1000000,32482090,62561449,31482090,61561449,31.6227766017,18.9630730035,19.268364577,39,0,0,
Taxi Driver,4498,1000000,28262574,28262574,27262574,27262574,31.6227766017,18.7406810313,19.2501225366,35,0,0,
An Inconvenient Truth,4499,1000000,23814997,52438751,22814997,51438751,31.6227766017,18.90242143,19.2305273422,89,0,0,
The Fog,4500,1000000,21378361,21378361,20378361,20378361,31.6227766017,18.6893986505,19.2196269131,77,0,0,
Chernobyl Diaries,4501,1000000,18119640,38390020,17119640,37390020,31.6227766017,18.8116429381,19.2048606098,57,0,0,
The Howling,4502,1000000,17985000,17985000,16985000,16985000,31.6227766017,18.6631188877,19.2042457974,64,0,0,
Dr. No,4503,1000000,16067035,59567035,15067035,58567035,31.6227766017,18.9455114985,19.1954464177,95,0,0,
Hellraiser,4504,1000000,13323420,13323420,12323420,12323420,31.6227766017,18.6258530719,19.1827229159,84,0,0,
Cry Wolf,4505,1000000,10047674,15943081,9047674,14943081,31.6227766017,18.6469659392,19.1673165337,61,0,0,
Godzilla 2000,4506,1000000,10037390,10037390,9037390,9037390,31.6227766017,18.5987234262,19.1672677907,55,0,0,
Blue Valentine,4507,1000000,9737892,16566240,8737892,15566240,31.6227766017,18.651923266,19.1658472171,45,0,0,
Transamerica,4508,1000000,9015303,16553163,8015303,15553163,31.6227766017,18.6518194884,19.162411515,73,0,0,
Beyond the Valley of the Dolls,4509,1000000,9000000,9000000,8000000,8000000,31.6227766017,18.5900035317,19.1623386259,31,0,0,
Love Me Tender,4510,1000000,9000000,9000000,8000000,8000000,31.6227766017,18.5900035317,19.1623386259,39,0,0,
Sands of Iwo Jima,4511,1000000,7800000,7800000,6800000,6800000,31.6227766017,18.5798210293,19.1566063448,27,0,0,
The Green Inferno,4512,1000000,7192291,8787893,6192291,7787893,31.6227766017,18.5882112421,19.1536907969,1,0,0,
The Sessions,4513,1000000,6002451,11495204,5002451,10495204,31.6227766017,18.6108501425,19.1479576815,39,0,0,
Shine a Light,4514,1000000,5371629,16040241,4371629,15040241,31.6227766017,18.6477404811,19.1449047488,51,0,0,
October Baby,4515,1000000,5355847,5355847,4355847,4355847,31.6227766017,18.5587550806,19.1448282504,3,0,0,
The Skeleton Twins,4516,1000000,5284309,5797192,4284309,4797192,31.6227766017,18.562591975,19.1444814187,69,0,0,
20 Feet From Stardom,4517,1000000,4946250,5892466,3946250,4892466,31.6227766017,18.5634183244,19.142840806,71,0,0,
"Food, Inc.",4518,1000000,4417674,4731944,3417674,3731944,31.6227766017,18.5533058536,19.1402702007,63,0,0,
"Next Stop, Wonderland",4519,1000000,3386698,3456820,2386698,2456820,31.6227766017,18.5420755782,19.1352371968,89,0,0,
Obvious Child,4520,1000000,3122616,3324070,2122616,2324070,31.6227766017,18.5408991407,19.1339439194,89,0,0,
Martha Marcy May Marlene,4521,1000000,2981038,5438911,1981038,4438911,31.6227766017,18.5594783346,19.1332498863,64,0,0,
Junebug,4522,1000000,2678010,3553253,1678010,2553253,31.6227766017,18.5429293055,19.1317627842,99,0,0,
Frozen River,4523,1000000,2511476,6030129,1511476,5030129,31.6227766017,18.5646111255,19.1309445802,64,0,0,
The Sidewalks of New York,4524,1000000,2402459,3575308,1402459,2575308,31.6227766017,18.5431244574,19.1304086022,42,0,0,
Two Girls and a Guy,4525,1000000,1950218,2208051,950218,1208051,31.6227766017,18.5309538103,19.1281821036,3,0,0,
The Broken Hearts Club: A Romantic Comedy,4526,1000000,1744858,2022442,744858,1022442,31.6227766017,18.5292901324,19.1271694246,47,0,0,
Who Killed the Electric Car?,4527,1000000,1678874,1849392,678874,849392,31.6227766017,18.5277365279,19.126843824,90,0,0,
Walking and Talking,4528,1000000,1231303,1559610,231303,559610,31.6227766017,18.5251295122,19.1246324647,55,0,0,
Bubba Ho-Tep,4529,1000000,1184656,1438368,184656,438368,31.6227766017,18.524036742,19.1244017095,52,0,0,
No Man's Land,4530,1000000,1059830,2676556,59830,1676556,31.6227766017,18.535140914,19.1237839534,15,0,0,
Slam,4531,1000000,982214,1059916,-17786,59916,31.6227766017,18.5206180024,19.1233996441,93,0,0,
Brigham City,4532,1000000,852206,852206,-147794,-147794,31.6227766017,18.5187366781,19.1227555891,38,0,0,
Panic,4533,1000000,767007,1413577,-232993,413577,31.6227766017,18.5238131503,19.1223332912,51,0,0,
Fiza,4534,1000000,623791,1179462,-376209,179462,31.6227766017,18.5216991825,19.1216230237,44,0,0,
Ajami,4535,1000000,621859,2721096,-378141,1721096,31.6227766017,18.535538064,19.1216134386,27,0,0,
Orgazmo,4536,1000000,582024,627287,-417976,-372713,31.6227766017,18.5166954847,19.1214157888,52,0,0,
The Future,4537,1000000,568662,568662,-431338,-431338,31.6227766017,18.5161627636,19.1213494816,56,0,0,
All the Real Girls,4538,1000000,549666,703020,-450334,-296980,31.6227766017,18.517383245,19.1212552089,67,0,0,
Dream With The Fishes,4539,1000000,542909,542909,-457091,-457091,31.6227766017,18.5159286583,19.1212216733,44,0,0,
The Act of Killing,4540,1000000,486919,487359,-513081,-512641,31.6227766017,18.5154234993,19.1209437469,25,0,0,
Blue Car,4541,1000000,464126,475367,-535874,-524633,31.6227766017,18.5153144132,19.1208305836,90,0,0,
Wristcutters: A Love Story,4542,1000000,446165,473769,-553835,-526231,31.6227766017,18.515299876,19.1207414013,74,0,0,
Luminarias,4543,1000000,428535,428535,-571465,-571465,31.6227766017,18.5148882889,19.1206538548,45,0,0,
I Origins,4544,1000000,336472,852399,-663528,-147601,31.6227766017,18.5187384278,19.1201965666,22,0,0,
The Battle of Shaker Heights,4545,1000000,280351,839145,-719649,-160855,31.6227766017,18.5186182603,19.1199177042,86,0,0,
Taxi to the Dark Side,4546,1000000,274661,304472,-725339,-695528,31.6227766017,18.5137585613,19.1198894265,22,0,0,
Guiana 1838,4547,1000000,227241,227241,-772759,-772759,31.6227766017,18.5130546445,19.1196537315,31,0,0,
Love Lisa,4548,1000000,213137,213137,-786863,-786863,31.6227766017,18.512926041,19.1195836187,14,0,0,
Once in a Lifetime: the Extraordinary Story of the New York Cosmos,4549,1000000,144601,215559,-855399,-784441,31.6227766017,18.5129481265,19.1192428474,81,0,0,
Lisa Picard is Famous,4550,1000000,113433,113433,-886567,-886567,31.6227766017,18.5120164452,19.1190878369,93,0,0,
Beyond the Brick: A LEGO Brickumentary,4551,1000000,101531,101531,-898469,-898469,31.6227766017,18.5119078084,19.1190286374,68,0,0,
The House of the Devil,4552,1000000,101215,102812,-898785,-897188,31.6227766017,18.5119195014,19.1190270656,1,0,0,
Hardflip,4553,1000000,96734,96734,-903266,-903266,31.6227766017,18.5118640199,19.1190047765,2,0,0,
Chocolate: Deep Dark Secrets,4554,1000000,49000,1549000,-951000,549000,31.6227766017,18.5250339305,19.1187673107,27,0,0,
The Perfect Host,4555,1000000,48764,48764,-951236,-951236,31.6227766017,18.5114260296,19.1187661365,21,0,0,
The Last Big Thing,4556,1000000,22434,22434,-977566,-977566,31.6227766017,18.5111855419,19.1186351264,42,0,0,
Safe Men,4557,1000000,21210,21210,-978790,-978790,31.6227766017,18.511174361,19.1186290358,27,0,0,
Speedway Junky,4558,1000000,17127,17127,-982873,-982873,31.6227766017,18.5111370629,19.1186087183,81,0,0,
Hits,4559,1000000,15156,15156,-984844,-984844,31.6227766017,18.5111190574,19.1185989103,23,0,0,
The Specials,4560,1000000,12996,12996,-987004,-987004,31.6227766017,18.5110993249,19.1185881616,69,0,0,
16 to Life,4561,1000000,11574,11574,-988426,-988426,31.6227766017,18.5110863342,19.1185810854,55,0,0,
Alone with Her,4562,1000000,10787,844377,-989213,-155623,31.6227766017,18.518665698,19.118577169,65,0,0,
Special,4563,1000000,7202,26822,-992798,-973178,31.6227766017,18.5112256242,19.1185593288,2,0,0,
The Sisterhood of Night,4564,1000000,6870,6870,-993130,-993130,31.6227766017,18.5110433594,19.1185576766,95,0,0,
Sparkler,4565,1000000,5494,5494,-994506,-994506,31.6227766017,18.5110307881,19.1185508291,59,0,0,
The Helix...  Loaded,4566,1000000,3700,3700,-996300,-996300,31.6227766017,18.5110143978,19.1185419013,91,0,0,
In Her Line of Fire,4567,1000000,884,884,-999116,-999116,31.6227766017,18.5109886698,19.1185278874,67,0,0,
The Jimmy Show,4568,1000000,703,703,-999297,-999297,31.6227766017,18.5109870161,19.1185269867,3,0,0,
And Then Came Love,4596,989000,8158,8158,-980842,-980842,31.5354529258,18.5111556162,19.1186188248,15,0,0,
Hard Candy,4597,950000,1024640,8267066,74640,7317066,31.2198564135,18.5842212695,19.1238572671,20,0,0,
Charly,4598,950000,813685,813685,-136315,-136315,31.2198564135,18.5188407411,19.1228124724,50,0,0,
L!fe Happens,4603,930000,30905,30905,-899095,-899095,31.0542279907,18.5119020941,19.1190255236,87,0,0,
On the Waterfront,4605,910000,9600000,9600000,8690000,8690000,30.8859061939,18.5958118615,19.1656198694,12,0,0,
Fruitvale Station,4606,900000,16098998,16928069,15198998,16028069,30.8007028824,18.655581397,19.1960543339,41,0,0,
"4 luni, 3 saptamani si 2 zile",4607,900000,1196321,11993156,296321,11093156,30.8007028824,18.6157819422,19.1249540095,25,0,0,
Circumstance,4608,900000,454121,958978,-445879,58978,30.8007028824,18.5206095144,19.1212773188,90,0,0,
The Quiet,4609,900000,381420,381420,-518580,-518580,30.8007028824,18.5153694762,19.1209164465,77,0,0,
The Brass Teapot,4610,900000,6997,6997,-893003,-893003,30.8007028824,18.5119577013,19.1190558252,81,0,0,
"For a Good Time, Call",4613,850000,1251749,1384038,401749,534038,30.3637027671,18.5248991277,19.1254751812,15,0,0,
Latter Days,4614,850000,833118,865708,-16882,15708,30.3637027671,18.5202178867,19.1234041211,44,0,0,
The Hammer,4615,850000,442638,442638,-407362,-407362,30.3637027671,18.5163806661,19.1214684562,94,0,0,
Windsor Drive,4616,850000,3256,3256,-846744,-846744,30.3637027671,18.5123798481,19.1192858877,2,0,0,
Celeste and Jesse Forever,4619,840000,3103407,3787689,2263407,2947689,30.2740010404,18.546413704,19.1346336172,42,0,0,
Time Changer,4620,825000,1500711,1500711,675711,675711,30.1379346709,18.5261748278,19.1268282134,100,0,0,
Jodaeiye Nader az Simin,4623,800000,7098492,24426169,6298492,23626169,29.9069756244,18.7139204268,19.1542009207,30,0,0,
Welcome to the Dollhouse,4624,800000,4198137,5034794,3398137,4234794,29.9069756244,18.5577001116,19.1401750604,27,0,0,
Raising Victor Vargas,4625,800000,2073984,2900578,1273984,2100578,29.9069756244,18.538915411,19.1297765908,27,0,0,
Ruby in Paradise,4626,800000,1001437,1001437,201437,201437,29.9069756244,18.5218977984,19.1244847286,14,0,0,
Pandora's Box,4627,800000,881950,881950,81950,81950,29.9069756244,18.5208173669,19.1238934517,34,0,0,
Cama adentro,4628,800000,200433,200433,-599567,-599567,29.9069756244,18.5146325016,19.1205142909,4,0,0,
Deterrence,4629,800000,144583,371647,-655417,-428353,29.9069756244,18.516189895,19.1202368634,76,0,0,
The Mudge Boy,4630,800000,62544,62544,-737456,-737456,29.9069756244,18.5133764728,19.1198292058,37,0,0,
The Young Unknowns,4631,800000,58163,58163,-741837,-741837,29.9069756244,18.5133365405,19.1198074316,61,0,0,
Dod sno,4632,800000,46742,2194020,-753258,1394020,29.9069756244,18.5326179438,19.1197506655,23,0,0,
Not Cool,4633,800000,35688,35688,-764312,-764312,29.9069756244,18.5131316582,19.1196957203,17,0,0,
Kill List,4634,800000,29063,462206,-770937,-337794,29.9069756244,18.5170126562,19.1196627886,54,0,0,
Saints and Soldiers,4636,780000,1310470,1310470,530470,530470,29.718278662,18.5248669785,19.1261111312,69,0,0,
American Graffiti,4637,777000,115000000,140000000,114223000,139223000,29.689662087,19.335663589,19.5717726396,59,0,0,
Kevin Hart: Laugh at My Pain,4639,750000,7706436,7712436,6956436,6962436,29.4283095638,18.5812054494,19.1573554893,50,0,0,
Aqua Teen Hunger Force Colon Movie Film for Theaters,4640,750000,5520368,5520368,4770368,4770368,29.4283095638,18.5623591966,19.1468355737,62,0,0,
Safety Not Guaranteed,4641,750000,4010957,4422318,3260957,3672318,29.4283095638,18.5527835167,19.1395067726,22,0,0,
The Innkeepers,4642,750000,78396,1011535,-671604,261535,29.4283095638,18.5224407787,19.1201564422,78,0,0,
Il conformista,4643,750000,59656,59656,-690344,-690344,29.4283095638,18.5138057927,19.120063329,33,0,0,
Interview with the Assassin,4644,750000,47329,47329,-702671,-702671,29.4283095638,18.5136934776,19.1200020752,22,0,0,
Undead,4645,750000,41196,229250,-708804,-520750,29.4283095638,18.5153497365,19.1199715985,33,0,0,
Donkey Punch,4646,750000,19367,814801,-730633,64801,29.4283095638,18.5206622055,19.1198631161,56,0,0,
La mariée était en noir ,4650,747000,44566,44566,-702434,-702434,29.3988370085,18.5136956371,19.1200032529,13,0,0,
High Noon,4651,730000,8000000,8000000,7270000,7270000,29.2301278569,18.5838215371,19.1588554044,88,0,0,
Hoop Dreams,4652,700000,7746701,11746701,7046701,11046701,28.9250760852,18.61539966,19.1577874973,94,0,0,
Rize,4653,700000,3278611,4857731,2578611,4157731,28.9250760852,18.5570279323,19.1361759957,28,0,0,
Half Nelson,4654,700000,2697938,4911725,1997938,4211725,28.9250760852,18.5574989405,19.1333327575,37,0,0,
L.I.E.,4655,700000,1140965,1140965,440965,440965,28.9250760852,18.5240601616,19.1256689718,77,0,0,
Naturally Native,4656,700000,10508,10508,-689492,-689492,28.9250760852,18.5138135551,19.1200675625,22,0,0,
King Kong,4659,672000,10000000,10000000,9328000,9328000,28.6313824549,18.6011526079,19.1686442804,0,0,0,
House of Wax,4660,658000,23800000,23800000,23142000,23142000,28.4810812931,18.7103027486,19.2319812072,64,0,0,
Hav Plenty,4661,650000,2301777,2301777,1651777,1651777,28.3941151443,18.5349198987,19.1316339423,6,0,0,
Escape from Tomorrow,4662,650000,171962,171962,-478038,-478038,28.3941151443,18.515738201,19.1211177044,17,0,0,
Top Hat,4667,609000,1782000,3202000,1173000,2593000,27.9353632625,18.5432809761,19.1292795362,42,0,0,
Woodstock,4668,600000,34505110,34505110,33905110,33905110,27.8315768371,18.78778854,19.2786914351,71,0,0,
The Kentucky Fried Movie,4669,600000,15000000,20000000,14400000,19400000,27.8315768371,18.6818923598,19.1923679083,69,0,0,
Per qualche dollaro in più,4670,600000,4300000,4300000,3700000,3700000,27.8315768371,18.553026051,19.141644049,7,0,0,
Mercy Streets,4671,600000,173599,173599,-426401,-426401,27.8315768371,18.5162076367,19.1213739813,95,0,0,
Water & Power,4672,600000,42557,42557,-557443,-557443,27.8315768371,18.5150158941,19.1207234854,70,0,0,
Arnolds Park,4673,600000,23616,23616,-576384,-576384,27.8315768371,18.5148435204,19.1206294268,31,0,0,
Broken Vessels,4674,600000,15030,85343,-584970,-514657,27.8315768371,18.5154051614,19.1205867869,32,0,0,
A Hard Day's Night,4680,560000,1537860,1537860,977860,977860,27.3556479973,18.5288901159,19.1283183346,89,0,0,
The Harvest/La Cosecha,4681,560000,3709,3709,-556291,-556291,27.3556479973,18.515026377,19.1207292058,96,0,0,
Mata Hari,4683,558000,900000,900000,342000,342000,27.3311905317,18.5231673119,19.1251798519,68,0,0,
Friday the 13th,4684,550000,39754601,59754601,39204601,59204601,27.2326981533,18.9492765959,19.3009127937,23,0,0,
Love Letters,4685,550000,5269990,5269990,4719990,4719990,27.2326981533,18.5619218701,19.1465918325,31,0,0,
Faith Connections,4686,550000,9111,9111,-540889,-540889,27.2326981533,18.5151665205,19.1208056833,1,0,0,
Fireproof,4688,500000,33456317,33473297,32956317,32973297,26.5914794847,18.781312622,19.2746603943,47,0,0,
Benji,4689,500000,31559560,31559560,31059560,31059560,26.5914794847,18.7678795448,19.2665527927,2,0,0,
Open Water,4690,500000,30500882,55518641,30000882,55018641,26.5914794847,18.924293717,19.2619987736,85,0,0,
Kingdom of the Spiders,4691,500000,17000000,17000000,16500000,16500000,26.5914794847,18.6593057725,19.2020279827,11,0,0,
Mad Hot Ballroom,4692,500000,8045515,9315135,7545515,8815135,26.5914794847,18.5968616271,19.1601714601,16,0,0,
The Station Agent,4693,500000,5739376,9408027,5239376,8908027,26.5914794847,18.5976401921,19.1491019029,79,0,0,
To Save a Life,4694,500000,3777210,3824868,3277210,3324868,26.5914794847,18.5497343388,19.1395859742,80,0,0,
Wordplay,4695,500000,3119555,3175921,2619555,2675921,26.5914794847,18.5440142407,19.1363761713,25,0,0,
Beyond the Mat,4696,500000,2047570,2047570,1547570,1547570,26.5914794847,18.5339898934,19.1311219717,67,0,0,
The Singles Ward,4697,500000,1250798,1250798,750798,750798,26.5914794847,18.5268502923,19.1271987306,81,0,0,
Sholem Aleichem: Laughing in the Darkness,4698,500000,1131261,1131261,631261,631261,26.5914794847,18.5257747512,19.12660881,34,0,0,
Osama,4699,500000,1127331,1971479,627331,1471479,26.5914794847,18.5333102653,19.1265894093,79,0,0,
Groove,4700,500000,1115313,1167524,615313,667524,26.5914794847,18.5261011519,19.1265300795,44,0,0,
The R.M.,4701,500000,1111615,1111615,611615,611615,26.5914794847,18.5255978744,19.1265118227,81,0,0,
Twin Falls Idaho,4702,500000,985341,1027228,485341,527228,26.5914794847,18.5248377658,19.125888216,62,0,0,
Mean Creek,4703,500000,603951,1348750,103951,848750,26.5914794847,18.5277307597,19.1240023491,98,0,0,
Drinking Buddies,4704,500000,343706,407100,-156294,-92900,26.5914794847,18.5192342223,19.122713466,14,0,0,
Hurricane Streets,4705,500000,334041,367582,-165959,-132418,26.5914794847,18.5188760669,19.1226655673,11,0,0,
Never Again,4706,500000,307631,308793,-192369,-191207,26.5914794847,18.5183430191,19.1225346706,33,0,0,
Shichinin no samurai,4707,500000,271736,271736,-228264,-228264,26.5914794847,18.5180068723,19.1223567356,12,0,0,
Civil Brand,4708,500000,254293,254293,-245707,-245707,26.5914794847,18.5178486064,19.1222702576,24,0,0,
Monsters,4709,500000,237301,5639730,-262699,5139730,26.5914794847,18.5655597631,19.1221860083,8,0,0,
Lonesome Jim,4710,500000,154187,602789,-345813,102789,26.5914794847,18.5210058824,19.1217738122,85,0,0,
Deceptive Practice: The Mysteries and Mentors of Ricky Jay,4711,500000,152449,152449,-347551,-347551,26.5914794847,18.5169240429,19.121765191,64,0,0,
The Other Dream Team,4712,500000,134109,290757,-365891,-209243,26.5914794847,18.5181794273,19.1216742118,17,0,0,
Rubber,4713,500000,100370,680914,-399630,180914,26.5914794847,18.5217123073,19.1215068212,8,0,0,
Johnny Suede,4714,500000,55000,55000,-445000,-445000,26.5914794847,18.5160385773,19.1212816812,45,0,0,
Finishing the Game,4715,500000,52850,53201,-447150,-446799,26.5914794847,18.5160222234,19.1212710109,98,0,0,
Kiss the Bride,4716,500000,32033,32033,-467967,-467967,26.5914794847,18.5158297745,19.1211676924,45,0,0,
The Journey,4717,500000,19800,19800,-480200,-480200,26.5914794847,18.5157185413,19.1211069729,44,0,0,
Home,4718,500000,15433,44793168,-484567,44293168,26.5914794847,18.8572788839,19.121085296,90,0,0,
The Slaughter Rule,4719,500000,13134,13134,-486866,-486866,26.5914794847,18.515657923,19.1210738841,51,0,0,
The Living Wake,4720,500000,12232,12232,-487768,-487768,26.5914794847,18.5156497202,19.1210694066,11,0,0,
Scott Walker: 30 Century Man,4721,500000,6840,77121,-493160,-422879,26.5914794847,18.5162396475,19.1210426408,82,0,0,
The Californians,4722,500000,4134,4134,-495866,-495866,26.5914794847,18.5155760742,19.121029208,11,0,0,
Born to Fly: Elizabeth Streb vs. Gravity,4723,500000,1822,1822,-498178,-498178,26.5914794847,18.515555047,19.1210177308,22,0,0,
Detention of the Dead,4724,500000,1778,1778,-498222,-498222,26.5914794847,18.5155546469,19.1210175124,24,0,0,
Paranormal Activity,4750,450000,107918810,194183034,107468810,193733034,25.9002006411,19.5331409593,19.5501782396,19,0,0,
Straight out of Brooklyn,4751,450000,2712293,2712293,2262293,2262293,25.9002006411,18.5403511974,19.1346281619,81,0,0,
Brick,4752,450000,2075743,4243996,1625743,3793996,25.9002006411,18.5538491533,19.1315060614,87,0,0,
Sunday,4753,450000,410919,450349,-39081,349,25.9002006411,18.5200788387,19.1232941779,82,0,0,
Conversations with Other Women,4754,450000,379418,1297745,-70582,847745,25.9002006411,18.5277217299,19.1231381446,0,0,0,
Siakh lokhamim: ha'slilim ha'gnouzim,4755,450000,19093,20336,-430907,-429664,25.9002006411,18.5161779791,19.1213516204,34,0,0,
Poultrygeist: Night of the Chicken Dead,4756,450000,13804,22623,-436196,-427377,25.9002006411,18.5161987659,19.1213253733,24,0,0,
As It Is in Heaven,4757,450000,13486,13486,-436514,-436514,25.9002006411,18.5161157161,19.1213237952,20,0,0,
42nd Street,4760,439000,1438000,2281000,999000,1842000,25.7404497035,18.5366153346,19.1284225086,24,0,0,
Metropolitan,4761,430000,2938000,2938000,2508000,2508000,25.6074960203,18.5425287686,19.1358306837,29,0,0,
Gory Gory Hallelujah,4762,425000,11798,11798,-413202,-413202,25.5327288107,18.5163275944,19.1214394781,81,0,0,
Blue Ruin,4763,420000,361276,368366,-58724,-51634,25.4572989502,18.5196080831,19.1231968835,84,0,0,
Napoleon Dynamite,4764,400000,44540956,46122713,44140956,45722713,25.1486685937,18.866474637,19.3211764974,84,0,0,
Monty Python and the Holy Grail,4765,400000,3427696,5028948,3027696,4628948,25.1486685937,18.5611310581,19.1383693891,6,0,0,
Quinceanera,4766,400000,1692693,2797199,1292693,2397199,25.1486685937,18.5415473849,19.1298686514,88,0,0,
Dogtown and Z-Boys,4767,400000,1293295,1600566,893295,1200566,25.1486685937,18.5308867732,19.1279015055,89,0,0,
Heroes,4768,400000,655538,655538,255538,255538,25.1486685937,18.5223866096,19.1247523304,82,0,0,
Tarnation,4769,400000,592014,1162014,192014,762014,25.1486685937,18.5269511496,19.1244381119,95,0,0,
I Want Your Money,4770,400000,433588,433588,33588,33588,25.1486685937,18.5203797335,19.1236540348,44,0,0,
E tu vivrai nel terrore - L'aldilà,4771,400000,126387,126387,-273613,-273613,25.1486685937,18.5175953542,19.122131891,77,0,0,
Home Movies,4772,400000,89134,89134,-310866,-310866,25.1486685937,18.5172571764,19.1219471493,4,0,0,
Jackpot,4773,400000,44452,44452,-355548,-355548,25.1486685937,18.5168514081,19.1217255213,91,0,0,
Fabled,4774,400000,31425,31425,-368575,-368575,25.1486685937,18.5167330757,19.1216608966,54,0,0,
The Dark Hours,4775,400000,423,423,-399577,-399577,25.1486685937,18.5164514087,19.1215070842,92,0,0,
The Broadway Melody,4781,379000,2800000,4358000,2421000,3979000,24.8118874507,18.5554672162,19.1354050598,90,0,0,
The Evil Dead,4782,375000,2400000,29400000,2025000,29025000,24.7461600192,18.7533976668,19.1334654451,51,0,0,
Trekkies,4783,375000,617172,617172,242172,242172,24.7461600192,18.5222658679,19.1246862243,86,0,0,
Maniac,4784,350000,10000000,10000000,9650000,9650000,24.322992791,18.6038373021,19.1701672411,18,0,0,
American Ninja 2: The Confrontation,4785,350000,4000000,4000000,3650000,3650000,24.322992791,18.5525879359,19.1414008777,67,0,0,
Murderball,4786,350000,1523883,1765708,1173883,1415708,24.322992791,18.5328118375,19.1292838835,56,0,0,
My Dog Tulip,4787,350000,246574,310891,-103426,-39109,24.322992791,18.5197215292,19.1229754332,33,0,0,
51 Birch Street,4788,350000,84689,84689,-265311,-265311,24.322992791,18.5176707031,19.1221730569,91,0,0,
Revolution#9,4789,350000,9118,9118,-340882,-340882,24.322992791,18.5169846118,19.1217982718,27,0,0,
Halloween,4793,325000,47000000,70000000,46675000,69675000,23.8765096392,19.0091629559,19.3314213866,20,0,0,
It Happened One Night,4794,325000,2500000,2500000,2175000,2175000,23.8765096392,18.5395764227,19.1342005903,96,0,0,
Dogtooth,4795,323000,110248,1373407,-212752,1050407,23.8396914732,18.5295409696,19.122433634,89,0,0,
Tumbleweeds,4796,312000,1277188,1715108,965188,1403108,23.6340771292,18.5326991964,19.1282558842,69,0,0,
Tupac Resurrection,4797,300000,7718961,7808524,7418961,7508524,23.4034731932,18.5858456808,19.1595671632,89,0,0,
God's Army,4798,300000,2628829,2643618,2328829,2343618,23.4034731932,18.541072463,19.1349539405,28,0,0,
Pieces of April,4799,300000,2498144,3540733,2198144,3240733,23.4034731932,18.5489945801,19.1343139702,90,0,0,
When The Cat's Away,4800,300000,1652472,2525984,1352472,2225984,23.4034731932,18.5400290074,19.1301627469,61,0,0,
Wendy and Lucy,4801,300000,865695,1416046,565695,1116046,23.4034731932,18.5301294835,19.1262850909,90,0,0,
Let's Talk About Sex,4802,300000,373615,373615,73615,73615,23.4034731932,18.5207419562,19.1238521933,8,0,0,
Old Joy,4803,300000,255923,399908,-44077,99908,23.4034731932,18.5209798222,19.1232694329,38,0,0,
First Morning,4804,300000,87264,87264,-212736,-212736,23.4034731932,18.5181477417,19.1224337133,97,0,0,
3 Backyards,4805,300000,39475,39475,-260525,-260525,23.4034731932,18.5177141383,19.1221967877,83,0,0,
Sisters in Law,4806,300000,33312,33312,-266688,-266688,23.4034731932,18.5176582059,19.1221662291,62,0,0,
Ayurveda: Art of Being,4807,300000,16892,2066892,-283108,1766892,23.4034731932,18.5359462489,19.1220848075,58,0,0,
"First Love, Last Rites",4808,300000,10876,10876,-289124,-289124,23.4034731932,18.5174545613,19.1220549744,60,0,0,
Fighting Tommy Riley,4809,300000,10240,10240,-289760,-289760,23.4034731932,18.5174487879,19.1220518204,10,0,0,
Locker 13,4810,300000,3496,3496,-296504,-296504,23.4034731932,18.5173875663,19.1220183761,3,0,0,
Compliance,4819,270000,319285,830700,49285,560700,22.7950705695,18.5251393311,19.1237317494,5,0,0,
Graduation Day,4820,250000,23894000,23894000,23644000,23644000,22.360679775,18.7140534093,19.234209009,63,0,0,
Chasing Amy,4821,250000,12006514,15155095,11756514,14905095,22.360679775,18.6466629585,19.1800735893,72,0,0,
Lovely and Amazing,4822,250000,4210379,4613482,3960379,4363482,22.360679775,18.5588215818,19.1429094284,4,0,0,
Better Luck Tomorrow,4823,250000,3802390,3809226,3552390,3559226,22.360679775,18.5517920556,19.1409259881,71,0,0,
Like Crazy,4824,250000,3395391,3731489,3145391,3481489,22.360679775,18.5511099762,19.1389434331,24,0,0,
The Incredibly True Adventure of Two Girls in Love,4825,250000,2210408,2477155,1960408,2227155,22.360679775,18.5400394,19.1331487152,50,0,0,
Chuck&Buck;,4826,250000,1055671,1157672,805671,907672,22.360679775,18.5282600224,19.1274694149,35,0,0,
American Desi,4827,250000,902835,1366235,652835,1116235,22.360679775,18.5301311776,19.1267153044,24,0,0,
Cube,4828,250000,489220,8969065,239220,8719065,22.360679775,18.5960557879,19.1246716236,34,0,0,
Love and Other Catastrophes,4829,250000,212285,743216,-37715,493216,22.360679775,18.5245312422,19.1233009435,85,0,0,
I Married a Strange Person,4830,250000,203134,203134,-46866,-46866,22.360679775,18.5196512711,19.1232556189,78,0,0,
November,4831,250000,191862,191862,-58138,-58138,22.360679775,18.5195491676,19.1231997862,80,0,0,
Sugar Town,4832,250000,178095,178095,-71905,-71905,22.360679775,18.5194244498,19.1231315909,59,0,0,
Happy Valley,4833,250000,67665,67665,-182335,-182335,22.360679775,18.518423481,19.1225844044,62,0,0,
The Canyons,4834,250000,59671,59671,-190329,-190329,22.360679775,18.5183509822,19.1225447821,59,0,0,
The Motel,4835,250000,51540,51540,-198460,-198460,22.360679775,18.5182772355,19.1225044792,85,0,0,
On the Outs,4836,250000,49772,237816,-200228,-12184,22.360679775,18.5199653608,19.1224957155,60,0,0,
Shotgun Stories,4837,250000,45661,283809,-204339,33809,22.360679775,18.5203817338,19.1224753377,43,0,0,
Test,4838,250000,18823,18823,-231177,-231177,22.360679775,18.5179804434,19.1223422942,21,0,0,
Sticky Fingers of Time,4839,250000,18195,20628,-231805,-229372,22.360679775,18.5179968198,19.1223391808,98,0,0,
Night Lights,4840,250000,12848,12848,-237152,-237152,22.360679775,18.5179262317,19.1223126721,31,0,0,
The Big Parade,4857,245000,11000000,22000000,10755000,21755000,22.2480279313,18.6998661367,19.1753759834,7,0,0,
Little Big Top,4858,240000,7484,7484,-232516,-232516,22.133638394,18.5179682948,19.122335656,88,0,0,
Bronson,4859,230000,104979,2703762,-125021,2473762,21.8993870309,18.5422256195,19.1228684357,46,0,0,
Burn,4860,225000,1109276,1109276,884276,884276,21.7793858735,18.528049903,19.1278570397,53,0,0,
Urbania,4861,225000,1032075,1032075,807075,807075,21.7793858735,18.5273562477,19.1274763398,0,0,0,
"The Beast from 20,000 Fathoms",4862,210000,5000000,5000000,4790000,4790000,21.4069514293,18.5625295682,19.146930542,8,0,0,
The Stewardesses,4863,200000,13500000,25000000,13300000,24800000,21.1474252688,18.722637265,19.1872703799,41,0,0,
Mad Max,4864,200000,8750000,99750000,8550000,99550000,21.1474252688,19.1626192411,19.1649549799,91,0,0,
"20,000 Leagues Under the Sea",4865,200000,8000000,8000000,7800000,7800000,21.1474252688,18.5883136319,19.1613855247,94,0,0,
Swingers,4866,200000,4505922,6618578,4305922,6418578,21.1474252688,18.5765626673,19.1445862159,6,0,0,
Per un pugno di dollari,4867,200000,3500000,3500000,3300000,3300000,21.1474252688,18.5495157434,19.1396970204,71,0,0,
The Grace Card,4868,200000,2430735,2430735,2230735,2230735,21.1474252688,18.5400711716,19.1344736082,100,0,0,
She Done Him Wrong,4869,200000,2000000,2000000,1800000,1800000,21.1474252688,18.5362412406,19.1323617129,8,0,0,
Trois,4870,200000,1160268,1160268,960268,960268,21.1474252688,18.5287322258,19.1282316363,59,0,0,
Short Cut to Nirvana: Kumbh Mela,4871,200000,381225,439651,181225,239651,21.1474252688,18.5222430928,19.1243847348,63,0,0,
Middle of Nowhere,4872,200000,236806,236806,36806,36806,21.1474252688,18.5204088595,19.1236699674,57,0,0,
Call+Response,4873,200000,212989,212989,12989,12989,21.1474252688,18.5201932725,19.1235520417,5,0,0,
The Business of Fancy Dancing,4874,200000,174682,174682,-25318,-25318,21.1474252688,18.5198464273,19.1233623422,34,0,0,
Hybrid,4875,200000,162605,162605,-37395,-37395,21.1474252688,18.5197370529,19.1233025284,40,0,0,
Baghead,4876,200000,140016,140016,-59984,-59984,21.1474252688,18.5195324453,19.1231906422,93,0,0,
Malevolence,4877,200000,126021,346106,-73979,146106,21.1474252688,18.5213976267,19.1231213169,27,0,0,
Side Effects,4878,200000,42110,42110,-157890,-157890,21.1474252688,18.5186451437,19.1227055565,73,0,0,
Good Dick,4879,200000,28835,52443,-171165,-147557,21.1474252688,18.5187388267,19.122639766,68,0,0,
The Case of the Grinning Cat,4880,200000,7033,7033,-192967,-192967,21.1474252688,18.5183270566,19.1225317065,17,0,0,
Solitude,4881,200000,5882,5882,-194118,-194118,21.1474252688,18.5183166173,19.1225260014,55,0,0,
The Word,4882,200000,3648,3648,-196352,-196352,21.1474252688,18.5182963552,19.122514928,59,0,0,
The Trials of Darryl Hunt,4883,200000,1217,1217,-198783,-198783,21.1474252688,18.5182743059,19.1225028781,76,0,0,
Weekend,4892,190000,469947,1562940,279947,1372940,20.8779762993,18.5324294497,19.1248730421,18,0,0,
Bacheha-Ye aseman,4893,180000,933933,1628579,753933,1448579,20.5976714391,18.5331056371,19.1272141973,48,0,0,
Butterfly Girl,4894,180000,8956,8956,-171044,-171044,20.5976714391,18.5185258718,19.1226403657,53,0,0,
She's Gotta Have It,4895,175000,7137502,7137502,6962502,6962502,20.4531174462,18.5812060115,19.157384527,59,0,0,
Another Earth,4896,175000,1321194,2102779,1146194,1927779,20.4531174462,18.5373789337,19.1291475525,91,0,0,
Dolphin,4898,170000,14000,14000,-156000,-156000,20.3054318487,18.5186622799,19.122714923,58,0,0,
The Horse Boy,4900,160000,156612,156612,-3388,-3388,20.0,18.520045004,19.1234709458,9,0,0,
The Calling,4901,160000,32092,32092,-127908,-127908,20.0,18.518916948,19.1228541305,69,0,0,
Sweet Sweetback's Baad Asssss Song,4902,150000,15200000,15200000,15050000,15050000,19.6798967127,18.6478182449,19.1953679154,50,0,0,
Once,4903,150000,9439923,23338122,9289923,23188122,19.6798967127,18.7106479336,19.1684640345,18,0,0,
Tadpole,4904,150000,2891288,3270128,2741288,3120128,19.6798967127,18.5479332029,19.1369710886,51,0,0,
Woman Chaser,4905,150000,110719,110719,-39281,-39281,19.6798967127,18.5197199714,19.1232931873,47,0,0,
Antarctic Edge: 70º South,4906,150000,7193,7193,-142807,-142807,19.6798967127,18.5187818891,19.1227803022,62,0,0,
Top Spin,4907,150000,5858,5858,-144142,-144142,19.6798967127,18.5187697865,19.1227736866,87,0,0,
The Texas Chainsaw Massacre,4912,140000,26572439,26572439,26432439,26432439,19.3433642027,18.7346347739,19.246494143,94,0,0,
Roger & Me,4913,140000,6477936,6477936,6337936,6337936,19.3433642027,18.5758724076,19.154390319,75,0,0,
Sound of My Voice,4914,135000,408015,429448,273015,294448,19.1682931274,18.52273802,19.1248387622,85,0,0,
Cat People,4915,134000,4000000,8000000,3866000,7866000,19.1326972577,18.5888716146,19.1424509542,13,0,0,
Your Sister's Sister,4919,120000,1597486,3090593,1477486,2970593,18.612097182,18.5466156626,19.1307775005,62,0,0,
Night of the Living Dead,4922,114000,12000000,30000000,11886000,29886000,18.3749519815,18.7595518297,19.1806793361,65,0,0,
The Birth of a Nation,4923,110000,10000000,11000000,9890000,10890000,18.2116028684,18.614109075,19.1713008603,44,0,0,
The Work and the Story,4924,103000,16137,16137,-86863,-86863,17.9146903606,18.5192889249,19.1230574908,40,0,0,
The Gallows,4925,100000,22764410,41364410,22664410,41264410,17.7827941004,18.8375120251,19.2298571165,88,0,0,
Facing the Giants,4926,100000,10178331,10243159,10078331,10143159,17.7827941004,18.6079351228,19.1721895265,56,0,0,
Eraserhead,4927,100000,7000000,7000000,6900000,6900000,17.7827941004,18.5806735426,19.157085292,90,0,0,
Hollywood Shuffle,4928,100000,5228617,5228617,5128617,5128617,17.7827941004,18.5654636169,19.1485671589,47,0,0,
Over the Hill to the Poorhouse,4929,100000,3000000,3000000,2900000,2900000,17.7827941004,18.54599307,19.1377461935,85,0,0,
The Mighty,4930,100000,2643689,6113025,2543689,6013025,17.7827941004,18.5730864766,19.1360052301,14,0,0,
Penitentiary,4931,100000,287000,287000,187000,187000,17.7827941004,18.5217673174,19.1244133062,71,0,0,
The Lost Skeleton of Cadavra,4932,100000,110536,110536,10536,10536,17.7827941004,18.5201710658,19.1235398953,62,0,0,
Cheap Thrills,4933,100000,59424,59424,-40576,-40576,17.7827941004,18.5197082424,19.1232867733,97,0,0,
The Past is a Grotesque Animal,4934,100000,20056,20056,-79944,-79944,17.7827941004,18.5193516158,19.1230917674,34,0,0,
Keeping it Real: The Adventures of Greg Walloch,4935,100000,1358,1358,-98642,-98642,17.7827941004,18.51918219,19.1229991351,4,0,0,
The Last House on the Left,4944,87000,3100000,3100000,3013000,3013000,17.1743303821,18.5469894835,19.1382976879,94,0,0,
Dawn of the Crescent Moon,4945,75000,8799,8799,-66201,-66201,16.5487545982,18.5194761253,19.1231598464,25,0,0,
Happy Christmas,4947,70000,30312,30312,-39688,-39688,16.265765617,18.5197162852,19.1232911715,12,0,0,
"Peace, Propaganda and the Promised Land",4948,70000,4930,4930,-65070,-65070,16.265765617,18.5194863713,19.1231654489,51,0,0,
Pi,4950,68000,3216970,4674331,3148970,4606331,16.1483155842,18.5609345046,19.1389608841,8,0,0,
I Love You  Don't Touch Me!,4951,68000,33598,33598,-34402,-34402,16.1483155842,18.5197641599,19.1233173522,81,0,0,
20 Dates,4952,66000,536767,598051,470767,532051,16.0282454303,18.5248812241,19.125816217,44,0,0,
Super Size Me,4953,65000,11529368,22233808,11464368,22168808,15.9671843379,18.7029912906,19.1787055554,19,0,0,
The Blair Witch Project,4954,60000,140539099,248300000,140479099,248240000,15.6508458007,19.6979697384,19.6515498383,60,0,0,
Supporting Characters,4955,60000,4917,4917,-55083,-55083,15.6508458007,18.5195768413,19.1232149186,5,0,0,
The Brothers McMullen,4959,50000,10202068,10202068,10152068,10152068,14.9534878122,18.6080089964,19.1725372498,19,0,0,
Gabriela,4960,50000,2335352,2335352,2285352,2285352,14.9534878122,18.5405557589,19.1347410772,25,0,0,
Tiny Furniture,4961,50000,391674,424149,341674,374149,14.9534878122,18.5234574435,19.1251782403,17,0,0,
The Signal,4962,50000,251150,406299,201150,356299,14.9534878122,18.5232963649,19.1244833088,57,0,0,
Counting,4963,50000,8374,8374,-41626,-41626,14.9534878122,18.5196987323,19.1232815727,74,0,0,
The Salt of the Earth,4969,44936,1343349,4166640,1298413,4121704,14.5595718081,18.5567135331,19.1298967959,15,0,0,
George Washington,4970,42000,241816,342722,199816,300722,14.3156912274,18.5227946712,19.1244767095,99,0,0,
Smiling Fish and Goat on Fire,4972,40000,277233,277233,237233,237233,14.1421356237,18.5222212477,19.1246617957,99,0,0,
The Exploding Girl,4973,40000,25572,25572,-14428,-14428,14.1421356237,18.5199450415,19.1234162741,55,0,0,
Raymond Did It,4974,40000,3632,3632,-36368,-36368,14.1421356237,18.5197463543,19.123307615,19,0,0,
The Last Waltz,4975,35000,321952,321952,286952,286952,13.6778239987,18.5226703305,19.1249076817,58,0,0,
The Legend of God's Gun,4978,30000,243768,243768,213768,213768,13.1607401295,18.522009232,19.1245457282,17,0,0,
Mutual Appreciation,4979,30000,103509,103509,73509,73509,13.1607401295,18.5207409971,19.1238516686,37,0,0,
Funny Ha Ha,4980,30000,77070,82698,47070,52698,13.1607401295,18.520552685,19.1237207835,52,0,0,
Down Terrace,4981,30000,9812,9812,-20188,-20188,13.1607401295,18.5198928831,19.1233877485,93,0,0,
Clerks,4983,27000,2852326,3673138,2825326,3646138,12.8186101919,18.5525540879,19.1373815815,58,0,0,
Pink Narcissus,4984,27000,8231,8231,-18769,-18769,12.8186101919,18.5199057328,19.123394776,39,0,0,
Deep Throat,4985,25000,45000000,45000000,44975000,44975000,12.5743342968,18.8616754152,19.3245600559,58,0,0,
In the Company of Men,4986,25000,2856622,2856622,2831622,2831622,12.5743342968,18.5453896427,19.1374123282,12,0,0,
The Terrorist,4987,25000,195043,195043,170043,170043,12.5743342968,18.521614039,19.1243294104,11,0,0,
Slacker,4992,23000,1227508,1227508,1204508,1204508,12.3149303238,18.5309220791,19.1294346486,33,0,0,
The Puffy Chair,4998,15000,194523,195254,179523,180254,11.066819197,18.5217063415,19.1243763142,59,0,0,
Breaking Upwards,4999,15000,115592,115592,100592,100592,11.066819197,18.5209860094,19.123985724,43,0,0,
Pink Flamingos,5001,12000,413802,413802,401802,401802,10.4663513939,18.5237069333,19.1254754431,48,0,0,
Grip: A Criminal's Story,5002,12000,1336,1336,-10664,-10664,10.4663513939,18.519979124,19.1234349143,21,0,0,
Dayereh,5004,10000,673780,673780,663780,663780,10.0,18.5260674574,19.1267693272,76,0,0,
Clean,5005,10000,138711,138711,128711,128711,10.0,18.5212403307,19.1241248884,31,0,0,
Cure,5006,10000,94596,94596,84596,84596,10.0,18.5208413053,19.1239065492,100,0,0,
On the Down Low,5007,10000,1987,1987,-8013,-8013,10.0,18.5200031278,19.1234480425,43,0,0,
Bang,5008,10000,527,527,-9473,-9473,10.0,18.5199899081,19.1234408123,92,0,0,
The Rise and Fall of Miss Thang,5009,10000,401,401,-9599,-9599,10.0,18.5199887673,19.1234401884,57,0,0,
Newlyweds,5011,9000,4584,4584,-4416,-4416,9.74003746425,18.5200356964,19.1234658551,74,0,0,
El Mariachi,5012,7000,2040920,2041928,2033920,2034928,9.14691219229,18.5383319488,19.1335091768,70,0,0,
Primer,5013,7000,424760,841926,417760,834926,9.14691219229,18.527606546,19.125554306,85,0,0,
Cavite,5014,7000,70071,71644,63071,64644,9.14691219229,18.5206607849,19.1237999978,57,0,0,
The Mongol King,5015,7000,900,900,-6100,-6100,9.14691219229,18.5200204489,19.1234575159,30,0,0,
Following,5016,6000,44705,236718,38705,230718,8.80111736793,18.5221623866,19.1236793693,57,0,0,
Return to the Land of Wonders,5017,5000,1338,1338,-3662,-3662,8.40896415254,18.5200425232,19.123469589,2,0,0,
Shanghai Calling,5019,3967,10443,10443,6476,6476,7.93625383818,18.52013431,19.1235197913,19,0,0,
My Date With Drew,5021,1100,181041,181041,179941,179941,5.75901449065,18.5217035123,19.1243783822,99,0,0,
Chic!,5022,587,587,587,0,0,4.9222030514,18.520075679,19.1234877231,62,0,0,
